id,ndex,species,legendary,type1,type2,ability1,ability2,abilityH,hp,attack,defense,spattack,spdefense,speed,total,percent.male,percent.female,pre.evolution,egg.group1,egg.group2,weightlbs,feet_inches,ovrattack,ovrdefense,gen
1,1,Bulbasaur,0,Grass,Poison,Overgrow,,Chlorophyll,45,49,49,65,65,45,318,0.875,0.125,,Monster,Grass,15.2,2.04,114,114,1
2,2,Ivysaur,0,Grass,Poison,Overgrow,,Chlorophyll,60,62,63,80,80,60,405,0.875,0.125,Bulbasaur,Monster,Grass,28.7,3.03,142,143,1
3,3,Venusaur,0,Grass,Poison,Overgrow,,Chlorophyll,80,82,83,100,100,80,525,0.875,0.125,Ivysaur,Monster,Grass,220.5,6.07,182,183,1
4,4,Charmander,0,Fire,,Blaze,,Solar Power,39,52,43,60,50,65,309,0.875,0.125,,Monster,Dragon,18.7,2,112,93,1
5,5,Charmeleon,0,Fire,,Blaze,,Solar Power,58,64,58,80,65,80,405,0.875,0.125,Charmander,Monster,Dragon,41.9,3.07,144,123,1
6,6,Charizard,0,Fire,Flying,Blaze,,Solar Power,78,84,78,109,85,100,534,0.875,0.125,Charmeleon,Monster,Dragon,199.5,5.07,193,163,1
7,7,Squirtle,0,Water,,Torrent,,Rain Dish,44,48,65,50,64,43,314,0.875,0.125,,Monster,Water 1,19.8,1.08,98,129,1
8,8,Wartortle,0,Water,,Torrent,,Rain Dish,59,63,80,65,80,58,405,0.875,0.125,Squirtle,Monster,Water 1,49.6,3.03,128,160,1
9,9,Blastoise,0,Water,,Torrent,,Rain Dish,79,83,100,85,105,78,530,0.875,0.125,Wartortle,Monster,Water 1,188.5,5.03,168,205,1
10,10,Caterpie,0,Bug,,Shield Dust,,Run Away,45,30,35,20,20,45,195,0.5,0.5,,Bug,,6.4,1,50,55,1
11,11,Metapod,0,Bug,,Shed Skin,,,50,20,55,25,25,30,205,0.5,0.5,Caterpie,Bug,,21.8,2.04,45,80,1
12,12,Butterfree,0,Bug,Flying,Compound Eyes,,Tinted Lens,60,45,50,90,80,70,395,0.5,0.5,Metapod,Bug,,70.5,3.07,135,130,1
13,13,Weedle,0,Bug,Poison,Shield Dust,,Run Away,40,35,30,20,20,50,195,0.5,0.5,,Bug,,7.1,1,55,50,1
14,14,Kakuna,0,Bug,Poison,Shed Skin,Shed Skin,,45,25,50,25,25,35,205,0.5,0.5,Weedle,Bug,,22,2,50,75,1
15,15,Beedrill,0,Bug,Poison,Swarm,Swarm,Sniper,65,90,40,45,80,75,395,0.5,0.5,Kakuna,Bug,,65,3.03,135,120,1
16,16,Pidgey,0,Normal,Flying,Keen Eye,Tangled Feet,Big Pecks,40,45,40,35,35,56,251,0.5,0.5,,Flying,,4,1,80,75,1
17,17,Pidgeotto,0,Normal,Flying,Keen Eye,Tangled Feet,Big Pecks,63,60,55,50,50,71,349,0.5,0.5,Pidgey,Flying,,66.1,3.07,110,105,1
18,18,Pidgeot,0,Normal,Flying,Keen Eye,Tangled Feet,Big Pecks,83,80,75,70,70,101,479,0.5,0.5,Pidgeotto,Flying,,87.1,4.11,150,145,1
19,19,Rattata,0,Normal,,Run Away,Guts,Hustle,30,56,35,25,35,72,253,0.5,0.5,,Field,,7.7,1,81,70,1
20,20,Raticate,0,Normal,,Run Away,Guts,Hustle,55,81,60,50,70,97,413,0.5,0.5,Rattata,Field,,40.8,2.04,131,130,1
21,21,Spearow,0,Normal,Flying,Keen Eye,Keen Eye,Sniper,40,60,30,31,31,70,262,0.5,0.5,,Flying,,4.4,1,91,61,1
22,22,Fearow,0,Normal,Flying,Keen Eye,Keen Eye,Sniper,65,90,65,61,61,100,442,0.5,0.5,Spearow,Flying,,83.8,3.11,151,126,1
23,23,Ekans,0,Poison,,Intimidate,Shed Skin,Unnerve,35,60,44,40,54,55,288,0.5,0.5,,Field,Dragon,15.2,6.07,100,98,1
24,24,Arbok,0,Poison,,Intimidate,Shed Skin,Unnerve,60,95,69,65,79,80,448,0.5,0.5,Ekans,Field,Dragon,143.3,11.06,160,148,1
25,25,Pikachu,0,Electric,,Static,Static,Lightning Rod,35,55,40,50,50,90,320,0.5,0.5,Pichu,Field,Fairy,13.2,1.04,105,90,1
26,26,Raichu,0,Electric,,Static,Static,Lightning Rod,60,90,55,90,80,110,485,0.5,0.5,Pikachu,Field,Fairy,66.1,2.07,180,135,1
27,27,Sandshrew,0,Ground,,Sand Veil,,Sand Rush,50,75,85,20,30,40,300,0.5,0.5,,Field,,26.5,2,95,115,1
28,28,Sandslash,0,Ground,,Sand Veil,,Sand Rush,75,100,110,45,55,65,450,0.5,0.5,Sandshrew,Field,,65,3.03,145,165,1
29,29,Nidoran♀,0,Poison,,Poison Point,Rivalry,Hustle,55,47,52,40,40,41,275,0,1,,Monster,Field,15.4,1.04,87,92,1
30,30,Nidorina,0,Poison,,Poison Point,Rivalry,Hustle,70,62,67,55,55,56,365,0,1,Nidoran♀,Undiscovered,,44.1,2.07,117,122,1
31,31,Nidoqueen,0,Poison,Ground,Poison Point,Rivalry,Sheer Force,90,92,87,75,85,76,505,0,1,Nidorina,Undiscovered,,132.3,4.03,167,172,1
32,32,Nidoran♂,0,Poison,,Poison Point,Rivalry,Hustle,46,57,40,40,40,50,273,1,0,,Monster,Field,19.8,1.08,97,80,1
33,33,Nidorino,0,Poison,,Poison Point,Rivalry,Hustle,61,72,57,55,55,65,365,1,0,Nidoran♂,Monster,Field,43,2.11,127,112,1
34,34,Nidoking,0,Poison,Ground,Poison Point,Rivalry,Sheer Force,81,102,77,85,75,85,505,1,0,Nidorino,Monster,Field,136.7,4.07,187,152,1
35,35,Clefairy,0,Fairy,,Cute Charm,Magic Guard,Friend Guard,70,45,48,60,65,35,323,0.25,0.75,Cleffa,Fairy,,16.5,2,105,113,1
36,36,Clefable,0,Fairy,,Cute Charm,Magic Guard,Unaware,95,70,73,95,90,60,483,0.25,0.75,Clefairy,Fairy,,88.2,4.03,165,163,1
37,37,Vulpix,0,Fire,,Flash Fire,,Drought,38,41,40,50,65,65,299,0.25,0.75,,Field,,21.8,2,91,105,1
38,38,Ninetales,0,Fire,,Flash Fire,,Drought,73,76,75,81,100,100,505,0.25,0.75,Vulpix,Field,,43.9,3.07,157,175,1
39,39,Jigglypuff,0,Normal,Fairy,Cute Charm,Competitive,Friend Guard,115,45,20,45,25,20,270,0.25,0.75,Igglybuff,Fairy,,12.1,1.08,90,45,1
40,40,Wigglytuff,0,Normal,Fairy,Cute Charm,Competitive,Frisk,140,70,45,85,50,45,435,0.25,0.75,Jigglypuff,Fairy,,26.5,3.03,155,95,1
41,41,Zubat,0,Poison,Flying,Inner Focus,,Infiltrator,40,45,35,30,40,55,245,0.5,0.5,,Flying,,16.5,2.07,75,75,1
42,42,Golbat,0,Poison,Flying,Inner Focus,,Infiltrator,75,80,70,65,75,90,455,0.5,0.5,Zubat,Flying,,121.3,5.03,145,145,1
43,43,Oddish,0,Grass,Poison,Chlorophyll,,Run Away,45,50,55,75,65,30,320,0.5,0.5,,Grass,,11.9,1.08,125,120,1
44,44,Gloom,0,Grass,Poison,Chlorophyll,,Stench,60,65,70,85,75,40,395,0.5,0.5,Oddish,Grass,,19,2.07,150,145,1
45,45,Vileplume,0,Grass,Poison,Chlorophyll,,Effect Spore,75,80,85,110,90,50,490,0.5,0.5,Gloom,Grass,,41,3.11,190,175,1
46,46,Paras,0,Bug,Grass,Effect Spore,Dry Skin,Damp,35,70,55,45,55,25,285,0.5,0.5,,Bug,Grass,11.9,1,115,110,1
47,47,Parasect,0,Bug,Grass,Effect Spore,Dry Skin,Damp,60,95,80,60,80,30,405,0.5,0.5,Paras,Bug,Grass,65,3.03,155,160,1
48,48,Venonat,0,Bug,Poison,Compound Eyes,Tinted Lens,Run Away,60,55,50,40,55,45,305,0.5,0.5,,Bug,,66.1,3.03,95,105,1
49,49,Venomoth,0,Bug,Poison,Shield Dust,Tinted Lens,Wonder Skin,70,65,60,90,75,90,450,0.5,0.5,Venonat,Bug,,27.6,4.11,155,135,1
50,50,Diglett,0,Ground,,Sand Veil,Arena Trap,Sand Force,10,55,25,35,45,95,265,0.5,0.5,,Field,,1.8,0.08,90,70,1
51,51,Dugtrio,0,Ground,,Sand Veil,Arena Trap,Sand Force,35,100,50,50,70,120,425,0.5,0.5,Diglett,Field,,73.4,2.04,150,120,1
52,52,Meowth,0,Normal,,Pickup,Technician,Unnerve,40,45,35,40,40,90,290,0.5,0.5,,Field,,9.3,1.04,85,75,1
53,53,Persian,0,Normal,,Limber,Technician,Unnerve,65,70,60,65,65,115,440,0.5,0.5,Meowth,Field,,70.5,3.03,135,125,1
54,54,Psyduck,0,Water,,Damp,Cloud Nine,Swift Swim,50,52,48,65,50,55,320,0.5,0.5,,Water 1,Field,43.2,2.07,117,98,1
55,55,Golduck,0,Water,,Damp,Cloud Nine,Swift Swim,80,82,78,95,80,85,500,0.5,0.5,Psyduck,Water 1,Field,168.9,5.07,177,158,1
56,56,Mankey,0,Fighting,,Vital Spirit,Anger Point,Defiant,40,80,35,35,45,70,305,0.5,0.5,,Field,,61.7,1.08,115,80,1
57,57,Primeape,0,Fighting,,Vital Spirit,Anger Point,Defiant,65,105,60,60,70,95,455,0.5,0.5,Mankey,Field,,70.5,3.03,165,130,1
58,58,Growlithe,0,Fire,,Intimidate,Flash Fire,Justified,55,70,45,70,50,60,350,0.75,0.25,,Field,,41.9,2.04,140,95,1
59,59,Arcanine,0,Fire,,Intimidate,Flash Fire,Justified,90,110,80,100,80,95,555,0.75,0.25,Growlithe,Field,,341.7,6.03,210,160,1
60,60,Poliwag,0,Water,,Water Absorb,Damp,Swift Swim,40,50,40,40,40,90,300,0.5,0.5,,Water 1,,27.3,2,90,80,1
61,61,Poliwhirl,0,Water,,Water Absorb,Damp,Swift Swim,65,65,65,50,50,90,385,0.5,0.5,Poliwag,Water 1,,44.1,3.03,115,115,1
62,62,Poliwrath,0,Water,Fighting,Water Absorb,Damp,Swift Swim,90,95,95,70,90,70,510,0.5,0.5,Poliwhirl,Water 1,,119,4.03,165,185,1
63,63,Abra,0,Psychic,,Synchronize,Inner Focus,Magic Guard,25,20,15,105,55,90,310,0.75,0.25,,Human-Like,,43,2.11,125,70,1
64,64,Kadabra,0,Psychic,,Synchronize,Inner Focus,Magic Guard,40,35,30,120,70,105,400,0.75,0.25,Abra,Human-Like,,124.6,4.03,155,100,1
65,65,Alakazam,0,Psychic,,Synchronize,Inner Focus,Magic Guard,55,50,45,135,95,120,500,0.75,0.25,Kadabra,Human-Like,,105.8,4.11,185,140,1
66,66,Machop,0,Fighting,,Guts,No Guard,Steadfast,70,80,50,35,35,35,305,0.75,0.25,,Human-Like,,43,2.07,115,85,1
67,67,Machoke,0,Fighting,,Guts,No Guard,Steadfast,80,100,70,50,60,45,405,0.75,0.25,Machop,Human-Like,,155.4,4.11,150,130,1
68,68,Machamp,0,Fighting,,Guts,No Guard,Steadfast,90,130,80,65,85,55,505,0.75,0.25,Machoke,Human-Like,,286.6,5.03,195,165,1
69,69,Bellsprout,0,Grass,Poison,Chlorophyll,,Gluttony,50,75,35,70,30,40,300,0.5,0.5,,Grass,,8.8,2.04,145,65,1
70,70,Weepinbell,0,Grass,Poison,Chlorophyll,,Gluttony,65,90,50,85,45,55,390,0.5,0.5,Bellsprout,Grass,,14.1,3.03,175,95,1
71,71,Victreebel,0,Grass,Poison,Chlorophyll,,Gluttony,80,105,65,100,70,70,490,0.5,0.5,Weepinbell,Grass,,34.2,5.07,205,135,1
72,72,Tentacool,0,Water,Poison,Clear Body,Liquid Ooze,Rain Dish,40,40,35,50,100,70,335,0.5,0.5,,Water 3,,100.3,2.11,90,135,1
73,73,Tentacruel,0,Water,Poison,Clear Body,Liquid Ooze,Rain Dish,80,70,65,80,120,100,515,0.5,0.5,Tentacool,Water 3,,121.3,5.03,150,185,1
74,74,Geodude,0,Rock,Ground,Rock Head,Sturdy,Sand Veil,40,80,100,30,30,20,300,0.5,0.5,,Mineral,,44.1,1.04,110,130,1
75,75,Graveler,0,Rock,Ground,Rock Head,Sturdy,Sand Veil,55,95,115,45,45,35,390,0.5,0.5,Geodude,Mineral,,231.5,3.03,140,160,1
76,76,Golem,0,Rock,Ground,Rock Head,Sturdy,Sand Veil,80,120,130,55,65,45,495,0.5,0.5,Graveler,Mineral,,661.4,4.07,175,195,1
77,77,Ponyta,0,Fire,,Run Away,Flash Fire,Flame Body,50,85,55,65,65,90,410,0.5,0.5,,Field,,66.1,3.03,150,120,1
78,78,Rapidash,0,Fire,,Run Away,Flash Fire,Flame Body,65,100,70,80,80,105,500,0.5,0.5,Ponyta,Field,,209.4,5.07,180,150,1
79,79,Slowpoke,0,Water,Psychic,Oblivious,Own Tempo,Regenerator,90,65,65,40,40,15,315,0.5,0.5,,Monster,Water 1,79.4,3.11,105,105,1
80,80,Slowbro,0,Water,Psychic,Oblivious,Own Tempo,Regenerator,95,75,110,100,80,30,490,0.5,0.5,Slowpoke,Monster,Water 1,173.1,5.03,175,190,1
81,81,Magnemite,0,Electric,Steel,Magnet Pull,Sturdy,Analytic,25,35,70,95,55,45,325,NA,NA,,Mineral,,13.2,1,130,125,1
82,82,Magneton,0,Electric,Steel,Magnet Pull,Sturdy,Analytic,50,60,95,120,70,70,465,NA,NA,Magnemite,Mineral,,132.3,3.03,180,165,1
83,83,Farfetch’d,0,Normal,Flying,Keen Eye,Inner Focus,Defiant,52,90,55,58,62,60,377,0.5,0.5,,Flying,Field,33.1,2.07,148,117,1
84,84,Doduo,0,Normal,Flying,Run Away,Early Bird,Tangled Feet,35,85,45,35,35,75,310,0.5,0.5,,Flying,,86.4,4.07,120,80,1
85,85,Dodrio,0,Normal,Flying,Run Away,Early Bird,Tangled Feet,60,110,70,60,60,100,460,0.5,0.5,Doduo,Flying,,187.8,5.11,170,130,1
86,86,Seel,0,Water,,Thick Fat,Hydration,Ice Body,65,45,55,45,70,45,325,0.5,0.5,,Water 1,Field,198.4,3.07,90,125,1
87,87,Dewgong,0,Water,Ice,Thick Fat,Hydration,Ice Body,90,70,80,70,95,70,475,0.5,0.5,Seel,Water 1,Field,264.6,5.07,140,175,1
88,88,Grimer,0,Poison,,Stench,Sticky Hold,Poison Touch,80,80,50,40,50,25,325,0.5,0.5,,Amorphous,,66.1,2.11,120,100,1
89,89,Muk,0,Poison,,Stench,Sticky Hold,Poison Touch,105,105,75,65,100,50,500,0.5,0.5,Grimer,Amorphous,,66.1,3.11,170,175,1
90,90,Shellder,0,Water,,Shell Armor,Skill Link,Overcoat,30,65,100,45,25,40,305,0.5,0.5,,Water 3,,8.8,1,110,125,1
91,91,Cloyster,0,Water,Ice,Shell Armor,Skill Link,Overcoat,50,95,180,85,45,70,525,0.5,0.5,Shellder,Water 3,,292.1,4.11,180,225,1
92,92,Gastly,0,Ghost,Poison,Levitate,,,30,35,30,100,35,80,310,0.5,0.5,,Amorphous,,0.2,4.03,135,65,1
93,93,Haunter,0,Ghost,Poison,Levitate,,,45,50,45,115,55,95,405,0.5,0.5,Gastly,Amorphous,,0.2,5.03,165,100,1
94,94,Gengar,0,Ghost,Poison,Cursed Body,Cursed Body,Cursed Body,60,65,60,130,75,110,500,0.5,0.5,Haunter,Amorphous,,89.3,4.11,195,135,1
95,95,Onix,0,Rock,Ground,Rock Head,Sturdy,Weak Armor,35,45,160,30,45,70,385,0.5,0.5,,Mineral,,463,28.1,75,205,1
96,96,Drowzee,0,Psychic,,Insomnia,Forewarn,Inner Focus,60,48,45,43,90,42,328,0.5,0.5,,Human-Like,,71.4,3.03,91,135,1
97,97,Hypno,0,Psychic,,Insomnia,Forewarn,Inner Focus,85,73,70,73,115,67,483,0.5,0.5,Drowzee,Human-Like,,166.7,5.03,146,185,1
98,98,Krabby,0,Water,,Hyper Cutter,Shell Armor,Sheer Force,30,105,90,25,25,50,325,0.5,0.5,,Water 3,,14.3,1.04,130,115,1
99,99,Kingler,0,Water,,Hyper Cutter,Shell Armor,Sheer Force,55,130,115,50,50,75,475,0.5,0.5,Krabby,Water 3,,132.3,4.03,180,165,1
100,100,Voltorb,0,Electric,,Soundproof,Static,Aftermath,40,30,50,55,55,100,330,NA,NA,,Mineral,,22.9,1.08,85,105,1
101,101,Electrode,0,Electric,,Soundproof,Static,Aftermath,60,50,70,80,80,150,490,NA,NA,Voltorb,Mineral,,146.8,3.11,130,150,1
102,102,Exeggcute,0,Grass,Psychic,Chlorophyll,,Harvest,60,40,80,60,45,40,325,0.5,0.5,,Grass,,5.5,1.04,100,125,1
103,103,Exeggutor,0,Grass,Psychic,Chlorophyll,,Harvest,95,95,85,125,75,55,530,0.5,0.5,Exeggcute,Grass,,264.6,6.07,220,160,1
104,104,Cubone,0,Ground,,Rock Head,Lightning Rod,Battle Armor,50,50,95,40,50,35,320,0.5,0.5,,Monster,,14.3,1.04,90,145,1
105,105,Marowak,0,Ground,,Rock Head,Lightning Rod,Battle Armor,60,80,110,50,80,45,425,0.5,0.5,Cubone,Monster,,99.2,3.03,130,190,1
106,106,Hitmonlee,0,Fighting,,Limber,Reckless,Unburden,50,120,53,35,110,87,455,1,0,Tyrogue,Human-Like,,109.8,4.11,155,163,1
107,107,Hitmonchan,0,Fighting,,Keen Eye,Iron Fist,Inner Focus,50,105,79,35,110,76,455,1,0,Tyrogue,Human-Like,,110.7,4.07,140,189,1
108,108,Lickitung,0,Normal,,Own Tempo,Oblivious,Cloud Nine,90,55,75,60,75,30,385,0.5,0.5,,Monster,,144.4,3.11,115,150,1
109,109,Koffing,0,Poison,,Levitate,,,40,65,95,60,45,35,340,0.5,0.5,,Amorphous,,2.2,2,125,140,1
110,110,Weezing,0,Poison,,Levitate,,,65,90,120,85,70,60,490,0.5,0.5,Koffing,Amorphous,,20.9,3.11,175,190,1
111,111,Rhyhorn,0,Ground,Rock,Lightning Rod,Rock Head,Reckless,80,85,95,30,30,25,345,0.5,0.5,,Monster,Field,253.5,3.03,115,125,1
112,112,Rhydon,0,Ground,Rock,Lightning Rod,Rock Head,Reckless,105,130,120,45,45,40,485,0.5,0.5,Rhyhorn,Monster,Field,264.6,6.03,175,165,1
113,113,Chansey,0,Normal,,Natural Cure,Serene Grace,Healer,250,5,5,35,105,50,450,0,1,Happiny,Fairy,,76.3,3.07,40,110,1
114,114,Tangela,0,Grass,,Chlorophyll,Leaf Guard,Regenerator,65,55,115,100,40,60,435,0.5,0.5,,Grass,,77.2,3.03,155,155,1
115,115,Kangaskhan,0,Normal,,Early Bird,Scrappy,Inner Focus,105,95,80,40,80,90,490,0,1,,Monster,,176.4,7.03,135,160,1
116,116,Horsea,0,Water,,Swift Swim,Sniper,Damp,30,40,70,70,25,60,295,0.5,0.5,,Water 1,Dragon,17.6,1.04,110,95,1
117,117,Seadra,0,Water,,Poison Point,Sniper,Damp,55,65,95,95,45,85,440,0.5,0.5,Horsea,Water 1,Dragon,55.1,3.11,160,140,1
118,118,Goldeen,0,Water,,Swift Swim,Sniper,Damp,45,67,60,35,50,63,320,0.5,0.5,,Water 2,,33.1,2,102,110,1
119,119,Seaking,0,Water,,Swift Swim,Water Veil,Lightning Rod,80,92,65,65,80,68,450,0.5,0.5,Goldeen,Water 2,,86,4.03,157,145,1
120,120,Staryu,0,Water,,Illuminate,Natural Cure,Analytic,30,45,55,70,55,85,340,NA,NA,,Water 3,,76.1,2.07,115,110,1
121,121,Starmie,0,Water,Psychic,Illuminate,Natural Cure,Analytic,60,75,85,100,85,115,520,NA,NA,Staryu,Water 3,,176.4,3.07,175,170,1
122,122,Mr. Mime,0,Psychic,Fairy,Soundproof,Filter,Technician,40,45,65,100,120,90,460,0.5,0.5,Mime Jr.,Human-Like,,120.1,4.03,145,185,1
123,123,Scyther,0,Bug,Flying,Swarm,Technician,Steadfast,70,110,80,55,80,105,500,0.5,0.5,,Bug,,123.5,4.11,165,160,1
124,124,Jynx,0,Ice,Psychic,Oblivious,Forewarn,Dry Skin,65,50,35,115,95,95,455,0,1,Smoochum,Human-Like,,89.5,4.07,165,130,1
125,125,Electabuzz,0,Electric,,Static,,Vital Spirit,65,83,57,95,85,105,490,0.75,0.25,Elekid,Human-Like,,66.1,3.07,178,142,1
126,126,Magmar,0,Fire,,Flame Body,,Vital Spirit,65,95,57,100,85,93,495,0.75,0.25,Magby,Human-Like,,98.1,4.03,195,142,1
127,127,Pinsir,0,Bug,,Hyper Cutter,Mold Breaker,Moxie,65,125,100,55,70,85,500,0.5,0.5,,Bug,,121.3,4.11,180,170,1
128,128,Tauros,0,Normal,,Intimidate,Anger Point,Sheer Force,75,100,95,40,70,110,490,1,0,,Field,,194.9,4.07,140,165,1
129,129,Magikarp,0,Water,,Swift Swim,,Rattled,20,10,55,15,20,80,200,0.5,0.5,,Water 2,Dragon,22,2.11,25,75,1
130,130,Gyarados,0,Water,Flying,Intimidate,,Moxie,95,125,79,60,100,81,540,0.5,0.5,Magikarp,Water 2,Dragon,518.1,21.04,185,179,1
131,131,Lapras,0,Water,Ice,Water Absorb,Shell Armor,Hydration,130,85,80,85,95,60,535,0.5,0.5,,Monster,Water 1,485,8.02,170,175,1
132,132,Ditto,0,Normal,,Limber,,Imposter,48,48,48,48,48,48,288,NA,NA,,Ditto,,8.8,1,96,96,1
133,133,Eevee,0,Normal,,Run Away,Adaptability,Anticipation,55,55,50,45,65,55,325,0.875,0.125,,Field,,14.3,1,100,115,1
134,134,Vaporeon,0,Water,,Water Absorb,,Hydration,130,65,60,110,95,65,525,0.875,0.125,Eevee,Field,,63.9,3.03,175,155,1
135,135,Jolteon,0,Electric,,Volt Absorb,,Quick Feet,65,65,60,110,95,130,525,0.875,0.125,Eevee,Field,,54,2.07,175,155,1
136,136,Flareon,0,Fire,,Flash Fire,,Guts,65,130,60,95,110,65,525,0.875,0.125,Eevee,Field,,55.1,2.11,225,170,1
137,137,Porygon,0,Normal,,Trace,Download,Analytic,65,60,70,85,75,40,395,0.875,0.125,,Mineral,,80.5,2.07,145,145,1
138,138,Omanyte,0,Rock,Water,Swift Swim,Shell Armor,Weak Armor,35,40,100,90,55,35,355,0.875,0.125,,Water 1,Water 3,16.5,1.04,130,155,1
139,139,Omastar,0,Rock,Water,Swift Swim,Shell Armor,Weak Armor,70,60,125,115,70,55,495,0.875,0.125,Omanyte,Water 1,Water 3,77.2,3.03,175,195,1
140,140,Kabuto,0,Rock,Water,Swift Swim,Battle Armor,Weak Armor,30,80,90,55,45,55,355,0.875,0.125,,Water 1,Water 3,25.4,1.08,135,135,1
141,141,Kabutops,0,Rock,Water,Swift Swim,Battle Armor,Weak Armor,60,115,105,65,70,80,495,0.875,0.125,Kabuto,Water 1,Water 3,89.3,4.03,180,175,1
142,142,Aerodactyl,0,Rock,Flying,Rock Head,Pressure,Unnerve,80,105,65,60,75,130,515,0.875,0.125,,Flying,,130.1,5.11,165,140,1
143,143,Snorlax,0,Normal,,Immunity,Thick Fat,Gluttony,160,110,65,65,110,30,540,0.875,0.125,Munchlax,Monster,,1014.1,6.11,175,175,1
144,144,Articuno,1,Ice,Flying,Pressure,,Snow Cloak,90,85,100,95,125,85,580,NA,NA,,Undiscovered,,122.1,5.07,180,225,1
145,145,Zapdos,1,Electric,Flying,Pressure,,Static,90,90,85,125,90,100,580,NA,NA,,Undiscovered,,116,5.03,215,175,1
146,146,Moltres,1,Fire,Flying,Pressure,,Flame Body,90,100,90,125,85,90,580,NA,NA,,Undiscovered,,132.3,6.07,225,175,1
147,147,Dratini,1,Dragon,,Shed Skin,,Marvel Scale,41,64,45,50,50,50,300,0.5,0.5,,Water 1,Dragon,7.3,5.11,114,95,1
148,148,Dragonair,1,Dragon,,Shed Skin,,Marvel Scale,61,84,65,70,70,70,420,0.5,0.5,Dratini,Water 1,Dragon,36.4,13.01,154,135,1
149,149,Dragonite,1,Dragon,Flying,Inner Focus,,Multiscale,91,134,95,100,100,80,600,1,0,Dragonair,Water 1,Dragon,463,7.03,234,195,1
150,150,Mewtwo,1,Psychic,,Pressure,,Unnerve,106,110,90,154,90,130,680,NA,NA,,Undiscovered,,269,6.07,264,180,1
151,151,Mew,1,Psychic,,Synchronize,,,100,100,100,100,100,100,600,NA,NA,,Undiscovered,,8.8,1.04,200,200,1
152,152,Chikorita,0,Grass,,Overgrow,,Leaf Guard,45,49,65,49,65,45,318,0.875,0.125,,Monster,Grass,14.1,2.11,98,130,2
153,153,Bayleef,0,Grass,,Overgrow,,Leaf Guard,60,62,80,63,80,60,405,0.875,0.125,Chikorita,Monster,Grass,34.8,3.11,125,160,2
154,154,Meganium,0,Grass,,Overgrow,,Leaf Guard,80,82,100,83,100,80,525,0.875,0.125,Bayleef,Monster,Grass,221.6,5.11,165,200,2
155,155,Cyndaquil,0,Fire,,Blaze,,Flash Fire,39,52,43,60,50,65,309,0.875,0.125,,Field,,17.4,1.08,112,93,2
156,156,Quilava,0,Fire,,Blaze,,Flash Fire,58,64,58,80,65,80,405,0.875,0.125,Cyndaquil,Field,,41.9,2.11,144,123,2
157,157,Typhlosion,0,Fire,,Blaze,,Flash Fire,78,84,78,109,85,100,534,0.875,0.125,Quilava,Field,,175.3,5.07,193,163,2
158,158,Totodile,0,Water,,Torrent,,Sheer Force,50,65,64,44,48,43,314,0.875,0.125,,Monster,Water 1,20.9,2,109,112,2
159,159,Croconaw,0,Water,,Torrent,,Sheer Force,65,80,80,59,63,58,405,0.875,0.125,Totodile,Monster,Water 1,55.1,3.07,139,143,2
160,160,Feraligatr,0,Water,,Torrent,,Sheer Force,85,105,100,79,83,78,530,0.875,0.125,Croconaw,Monster,Water 1,195.8,7.07,184,183,2
161,161,Sentret,0,Normal,,Run Away,Keen Eye,Frisk,35,46,34,35,45,20,215,0.5,0.5,,Field,,13.2,2.07,81,79,2
162,162,Furret,0,Normal,,Run Away,Keen Eye,Frisk,85,76,64,45,55,90,415,0.5,0.5,Sentret,Field,,71.6,5.11,121,119,2
163,163,Hoothoot,0,Normal,Flying,Insomnia,Keen Eye,Tinted Lens,60,30,30,36,56,50,262,0.5,0.5,,Flying,,46.7,2.04,66,86,2
164,164,Noctowl,0,Normal,Flying,Insomnia,Keen Eye,Tinted Lens,100,50,50,86,96,70,452,0.5,0.5,Hoothoot,Flying,,89.9,5.03,136,146,2
165,165,Ledyba,0,Bug,Flying,Swarm,Early Bird,Rattled,40,20,30,40,80,55,265,0.5,0.5,,Bug,,23.8,3.03,60,110,2
166,166,Ledian,0,Bug,Flying,Swarm,Early Bird,Iron Fist,55,35,50,55,110,85,390,0.5,0.5,Ledyba,Bug,,78.5,4.07,90,160,2
167,167,Spinarak,0,Bug,Poison,Swarm,Insomnia,Sniper,40,60,40,40,40,30,250,0.5,0.5,,Bug,,18.7,1.08,100,80,2
168,168,Ariados,0,Bug,Poison,Swarm,Insomnia,Sniper,70,90,70,60,70,40,400,0.5,0.5,Spinarak,Bug,,73.9,3.07,150,140,2
169,169,Crobat,0,Poison,Flying,Inner Focus,,Infiltrator,85,90,80,70,80,130,535,0.5,0.5,Golbat,Flying,,165.3,5.11,160,160,2
170,170,Chinchou,0,Water,Electric,Volt Absorb,Illuminate,Water Absorb,75,38,38,56,56,67,330,0.5,0.5,,Water 2,,26.5,1.08,94,94,2
171,171,Lanturn,0,Water,Electric,Volt Absorb,Illuminate,Water Absorb,125,58,58,76,76,67,460,0.5,0.5,Chinchou,Water 2,,49.6,3.11,134,134,2
172,172,Pichu,0,Electric,,Static,,Lightning Rod,20,40,15,35,35,60,205,0.5,0.5,,Undiscovered,,4.4,1,75,50,2
173,173,Cleffa,0,Fairy,,Cute Charm,Magic Guard,Friend Guard,50,25,28,45,55,15,218,0.25,0.75,,Undiscovered,,6.6,1,70,83,2
174,174,Igglybuff,0,Normal,Fairy,Cute Charm,Competitive,Friend Guard,90,30,15,40,20,15,210,0.25,0.75,,Undiscovered,,2.2,1,70,35,2
175,175,Togepi,0,Fairy,,Hustle,Serene Grace,Super Luck,35,20,65,40,65,20,245,0.875,0.125,,Undiscovered,,3.3,1,60,130,2
176,176,Togetic,0,Fairy,Flying,Hustle,Serene Grace,Super Luck,55,40,85,80,105,40,405,0.875,0.125,Togepi,Flying,Fairy,7.1,2,120,190,2
177,177,Natu,0,Psychic,Flying,Synchronize,Early Bird,Magic Bounce,40,50,45,70,45,70,320,0.5,0.5,,Flying,,4.4,0.08,120,90,2
178,178,Xatu,0,Psychic,Flying,Synchronize,Early Bird,Magic Bounce,65,75,70,95,70,95,470,0.5,0.5,Natu,Flying,,33.1,4.11,170,140,2
179,179,Mareep,0,Electric,,Static,,Plus,55,40,40,65,45,35,280,0.5,0.5,,Monster,Field,17.2,2,105,85,2
180,180,Flaaffy,0,Electric,,Static,,Plus,70,55,55,80,60,45,365,0.5,0.5,Mareep,Monster,Field,29.3,2.07,135,115,2
181,181,Ampharos,0,Electric,,Static,,Plus,90,75,85,115,90,55,510,0.5,0.5,Flaaffy,Monster,Field,135.6,4.07,190,175,2
182,182,Bellossom,0,Grass,,Chlorophyll,,Healer,75,80,95,90,100,50,490,0.5,0.5,Gloom,Grass,,12.8,1.04,170,195,2
183,183,Marill,0,Water,Fairy,Thick Fat,Huge Power,Sap Sipper,70,20,50,20,50,40,250,0.5,0.5,Azurill,Water 1,Fairy,18.7,1.04,40,100,2
184,184,Azumarill,0,Water,Fairy,Thick Fat,Huge Power,Sap Sipper,100,50,80,60,80,50,420,0.5,0.5,Marill,Water 1,Fairy,62.8,2.07,110,160,2
185,185,Sudowoodo,0,Rock,,Sturdy,Rock Head,Rattled,70,100,115,30,65,30,410,0.5,0.5,Bonsly,Mineral,,83.8,3.11,130,180,2
186,186,Politoed,0,Water,,Water Absorb,Damp,Drizzle,90,75,75,90,100,70,500,0.5,0.5,Poliwhirl,Water 1,,74.7,3.07,165,175,2
187,187,Hoppip,0,Grass,Flying,Chlorophyll,Leaf Guard,Infiltrator,35,35,40,35,55,50,250,0.5,0.5,,Fairy,Grass,1.1,1.04,70,95,2
188,188,Skiploom,0,Grass,Flying,Chlorophyll,Leaf Guard,Infiltrator,55,45,50,45,65,80,340,0.5,0.5,Hoppip,Fairy,Grass,2.2,2,90,115,2
189,189,Jumpluff,0,Grass,Flying,Chlorophyll,Leaf Guard,Infiltrator,75,55,70,55,95,110,460,0.5,0.5,Skiploom,Fairy,Grass,6.6,2.07,110,165,2
190,190,Aipom,0,Normal,,Run Away,Pickup,Skill Link,55,70,55,40,55,85,360,0.5,0.5,,Field,,25.4,2.07,110,110,2
191,191,Sunkern,0,Grass,,Chlorophyll,Solar Power,Early Bird,30,30,30,30,30,30,180,0.5,0.5,,Grass,,4,1,60,60,2
192,192,Sunflora,0,Grass,,Chlorophyll,Solar Power,Early Bird,75,75,55,105,85,30,425,0.5,0.5,Sunkern,Grass,,18.7,2.07,180,140,2
193,193,Yanma,0,Bug,Flying,Speed Boost,Compound Eyes,Frisk,65,65,45,75,45,95,390,0.5,0.5,,Bug,,83.8,3.11,140,90,2
194,194,Wooper,0,Water,Ground,Damp,Water Absorb,Unaware,55,45,45,25,25,15,210,0.5,0.5,,Water 1,Field,18.7,1.04,70,70,2
195,195,Quagsire,0,Water,Ground,Damp,Water Absorb,Unaware,95,85,85,65,65,35,430,0.5,0.5,Wooper,Water 1,Field,165.3,4.07,150,150,2
196,196,Espeon,0,Psychic,,Synchronize,,Magic Bounce,65,65,60,130,95,110,525,0.875,0.125,Eevee,Field,,58.4,2.11,195,155,2
197,197,Umbreon,0,Dark,,Synchronize,,Inner Focus,95,65,110,60,130,65,525,0.875,0.125,Eevee,Field,,59.5,3.03,125,240,2
198,198,Murkrow,0,Dark,Flying,Insomnia,Super Luck,Prankster,60,85,42,85,42,91,405,0.5,0.5,,Flying,,4.6,1.08,170,84,2
199,199,Slowking,0,Water,Psychic,Oblivious,Own Tempo,Regenerator,95,75,80,100,110,30,490,0.5,0.5,Slowpoke,Monster,Water 1,175.3,6.07,175,190,2
200,200,Misdreavus,0,Ghost,,Levitate,,,60,60,60,85,85,85,435,0.5,0.5,,Amorphous,,2.2,2.04,145,145,2
201,201,Unown,0,Psychic,,Levitate,,,48,72,48,72,48,48,336,NA,NA,Misdreavus,Undiscovered,,11,1.08,144,96,2
202,202,Wobbuffet,0,Psychic,,Shadow Tag,,Telepathy,190,33,58,33,58,33,405,0.5,0.5,Wynaut,Amorphous,,62.8,4.03,66,116,2
203,203,Girafarig,0,Normal,Psychic,Inner Focus,Early Bird,Sap Sipper,70,80,65,90,65,85,455,0.5,0.5,,Field,,91.5,4.11,170,130,2
204,204,Pineco,0,Bug,,Sturdy,,Overcoat,50,65,90,35,35,15,290,0.5,0.5,,Bug,,15.9,2,100,125,2
205,205,Forretress,0,Bug,Steel,Sturdy,,Overcoat,75,90,140,60,60,40,465,0.5,0.5,Pineco,Bug,,277.3,3.11,150,200,2
206,206,Dunsparce,0,Normal,,Serene Grace,Run Away,Rattled,100,70,70,65,65,45,415,0.5,0.5,,Field,,30.9,4.11,135,135,2
207,207,Gligar,0,Ground,Flying,Hyper Cutter,Sand Veil,Immunity,65,75,105,35,65,85,430,0.5,0.5,,Bug,,142.9,3.07,110,170,2
208,208,Steelix,0,Steel,Ground,Rock Head,Sturdy,Sheer Force,75,85,200,55,65,30,510,0.5,0.5,Onix,Mineral,,881.8,30.02,140,265,2
209,209,Snubbull,0,Fairy,,Intimidate,Run Away,Rattled,60,80,50,40,40,30,300,0.5,0.5,,Field,Fairy,17.2,2,120,90,2
210,210,Granbull,0,Fairy,,Intimidate,Quick Feet,Rattled,90,120,75,60,60,45,450,0.5,0.5,Snubbull,Field,Fairy,107.4,4.07,180,135,2
211,211,Qwilfish,0,Water,Poison,Poison Point,Swift Swim,Intimidate,65,95,85,55,55,85,440,0.5,0.5,,Water 2,,8.6,1.08,150,140,2
212,212,Scizor,0,Bug,Steel,Swarm,Technician,Light Metal,70,130,100,55,80,65,500,0.5,0.5,Scyther,Bug,,260.1,5.11,185,180,2
213,213,Shuckle,0,Bug,Rock,Sturdy,Gluttony,Contrary,20,10,230,10,230,5,505,0.5,0.5,,Bug,,45.2,2,20,460,2
214,214,Heracross,0,Bug,Fighting,Swarm,Guts,Moxie,80,125,75,40,95,85,500,0.5,0.5,,Bug,,119,4.11,165,170,2
215,215,Sneasel,0,Dark,Ice,Inner Focus,Keen Eye,Pickpocket,55,95,55,35,75,115,430,0.5,0.5,,Field,,61.7,2.11,130,130,2
216,216,Teddiursa,0,Normal,,Pickup,Quick Feet,Honey Gather,60,80,50,50,50,40,330,0.5,0.5,,Field,,19.4,2,130,100,2
217,217,Ursaring,0,Normal,,Guts,Quick Feet,Unnerve,90,130,75,75,75,55,500,0.5,0.5,Teddiursa,Field,,277.3,5.11,205,150,2
218,218,Slugma,0,Fire,,Magma Armor,Flame Body,Weak Armor,40,40,40,70,40,20,250,0.5,0.5,,Amorphous,,77.2,2.04,110,80,2
219,219,Magcargo,0,Fire,Rock,Magma Armor,Flame Body,Weak Armor,60,50,120,90,80,30,430,0.5,0.5,Slugma,Amorphous,,121.3,2.07,140,200,2
220,220,Swinub,0,Ice,Ground,Oblivious,Snow Cloak,Thick Fat,50,50,40,30,30,50,250,0.5,0.5,,Field,,14.3,1.04,80,70,2
221,221,Piloswine,0,Ice,Ground,Oblivious,Snow Cloak,Thick Fat,100,100,80,60,60,50,450,0.5,0.5,Swinub,Field,,123,3.07,160,140,2
222,222,Corsola,0,Water,Rock,Hustle,Natural Cure,Regenerator,65,55,95,65,95,35,410,0.5,0.5,,Water 1,Water 3,11,2,120,190,2
223,223,Remoraid,0,Water,,Hustle,Sniper,Moody,35,65,35,65,35,65,300,0.5,0.5,,Water 1,Water 2,26.5,2,130,70,2
224,224,Octillery,0,Water,,Suction Cups,Sniper,Moody,75,105,75,105,75,45,480,0.5,0.5,Remoraid,Water 1,Water 2,62.8,2.11,210,150,2
225,225,Delibird,0,Ice,Flying,Vital Spirit,Hustle,Insomnia,45,55,45,65,45,75,330,0.5,0.5,,Water 1,Field,35.3,2.11,120,90,2
226,226,Mantine,0,Water,Flying,Swift Swim,Water Absorb,Water Veil,85,40,70,80,140,70,485,0.5,0.5,Mantyke,Water 1,,485,6.11,120,210,2
227,227,Skarmory,0,Steel,Flying,Keen Eye,Sturdy,Weak Armor,65,80,140,40,70,70,465,0.5,0.5,,Flying,,111.3,5.07,120,210,2
228,228,Houndour,0,Dark,Fire,Early Bird,Flash Fire,Unnerve,45,60,30,80,50,65,330,0.5,0.5,,Field,,23.8,2,140,80,2
229,229,Houndoom,0,Dark,Fire,Early Bird,Flash Fire,Unnerve,75,90,50,110,80,95,500,0.5,0.5,Houndour,Field,,77.2,4.07,200,130,2
230,230,Kingdra,0,Water,Dragon,Swift Swim,Sniper,Damp,75,95,95,95,95,85,540,0.5,0.5,Seadra,Water 1,Dragon,335.1,5.11,190,190,2
231,231,Phanpy,0,Ground,,Pickup,,Sand Veil,90,60,60,40,40,40,330,0.5,0.5,,Field,,73.9,1.08,100,100,2
232,232,Donphan,0,Ground,,Sturdy,,Sand Veil,90,120,120,60,60,50,500,0.5,0.5,Phanpy,Field,,264.6,3.07,180,180,2
233,233,Porygon2,0,Normal,,Trace,Download,Analytic,85,80,90,105,95,60,515,NA,NA,Porygon,Mineral,,71.6,2,185,185,2
234,234,Stantler,0,Normal,,Intimidate,Frisk,Sap Sipper,73,95,62,85,65,85,465,0.5,0.5,,Field,,157,4.07,180,127,2
235,235,Smeargle,0,Normal,,Own Tempo,Technician,Moody,55,20,35,20,45,75,250,0.5,0.5,,Field,,127.9,3.11,40,80,2
236,236,Tyrogue,0,Fighting,,Guts,Steadfast,Vital Spirit,35,35,35,35,35,35,210,1,0,,Undiscovered,,46.3,2.04,70,70,2
237,237,Hitmontop,0,Fighting,,Intimidate,Technician,Steadfast,50,95,95,35,110,70,455,1,0,Tyrogue,Human-Like,,105.8,4.07,130,205,2
238,238,Smoochum,0,Ice,Psychic,Oblivious,Forewarn,Hydration,45,30,15,85,65,65,305,0,1,,Undiscovered,,13.2,1.04,115,80,2
239,239,Elekid,0,Electric,,Static,,Vital Spirit,45,63,37,65,55,95,360,0.75,0.25,,Undiscovered,,51.8,2,128,92,2
240,240,Magby,0,Fire,,Flame Body,,Vital Spirit,45,75,37,70,55,83,365,0.75,0.25,,Undiscovered,,47.2,2.04,145,92,2
241,241,Miltank,0,Normal,,Thick Fat,Scrappy,Sap Sipper,95,80,105,40,70,100,490,0,1,,Field,,166.4,3.11,120,175,2
242,242,Blissey,0,Normal,,Natural Cure,Serene Grace,Healer,255,10,10,75,135,55,540,0,1,Chansey,Fairy,,103.2,4.11,85,145,2
243,243,Raikou,0,Electric,,Pressure,,Inner Focus,90,85,75,115,100,115,580,NA,NA,,Undiscovered,,392.4,6.03,200,175,2
244,244,Entei,0,Fire,,Pressure,,Inner Focus,115,115,85,90,75,100,580,NA,NA,,Undiscovered,,436.5,6.11,205,160,2
245,245,Suicune,0,Water,,Pressure,,Inner Focus,100,75,115,90,115,85,580,NA,NA,,Undiscovered,,412.3,6.07,165,230,2
246,246,Larvitar,0,Rock,Ground,Guts,,Sand Veil,50,64,50,45,50,41,300,0.5,0.5,,Monster,,158.7,2,109,100,2
247,247,Pupitar,0,Rock,Ground,Shed Skin,,,70,84,70,65,70,51,410,0.5,0.5,Larvitar,Monster,,335.1,3.11,149,140,2
248,248,Tyranitar,0,Rock,Dark,Sand Stream,,Unnerve,100,134,110,95,100,61,600,0.5,0.5,Pupitar,Monster,,445.3,6.07,229,210,2
249,249,Lugia,0,Psychic,Flying,Pressure,,Multiscale,106,90,130,90,154,110,680,NA,NA,,Undiscovered,,476.2,17.01,180,284,2
250,250,Ho-Oh,0,Fire,Flying,Pressure,,Regenerator,106,130,90,110,154,90,680,NA,NA,,Undiscovered,,438.7,12.06,240,244,2
251,251,Celebi,0,Psychic,Grass,Natural Cure,,,100,100,100,100,100,100,600,NA,NA,,Undiscovered,,11,2,200,200,2
252,252,Treecko,0,Grass,,Overgrow,,Unburden,40,45,35,65,55,70,310,0.875,0.125,,Monster,Dragon,11,1.08,110,90,3
253,253,Grovyle,0,Grass,,Overgrow,,Unburden,50,65,45,85,65,95,405,0.875,0.125,Treecko,Monster,Dragon,47.6,2.11,150,110,3
254,254,Sceptile,0,Grass,,Overgrow,,Unburden,70,85,65,105,85,120,530,0.875,0.125,Grovyle,Monster,Dragon,115.1,5.07,190,150,3
255,255,Torchic,0,Fire,,Blaze,,Speed Boost,45,60,40,70,50,45,310,0.875,0.125,,Field,,5.5,1.04,130,90,3
256,256,Combusken,0,Fire,Fighting,Blaze,,Speed Boost,60,85,60,85,60,55,405,0.875,0.125,Torchic,Field,,43,2.11,170,120,3
257,257,Blaziken,0,Fire,Fighting,Blaze,,Speed Boost,80,120,70,110,70,80,530,0.875,0.125,Combusken,Field,,114.6,6.03,230,140,3
258,258,Mudkip,0,Water,,Torrent,,Damp,50,70,50,50,50,40,310,0.875,0.125,,Monster,Water 1,16.8,1.04,120,100,3
259,259,Marshtomp,0,Water,Ground,Torrent,,Damp,70,85,70,60,70,50,405,0.875,0.125,Mudkip,Monster,Water 1,61.7,2.04,145,140,3
260,260,Swampert,0,Water,Ground,Torrent,,Damp,100,110,90,85,90,60,535,0.875,0.125,Marshtomp,Monster,Water 1,180.6,4.11,195,180,3
261,261,Poochyena,0,Dark,,Run Away,Quick Feet,Rattled,35,55,35,30,30,35,220,0.5,0.5,,Field,,30,1.08,85,65,3
262,262,Mightyena,0,Dark,,Intimidate,Quick Feet,Moxie,70,90,70,60,60,70,420,0.5,0.5,Poochyena,Field,,81.6,3.03,150,130,3
263,263,Zigzagoon,0,Normal,,Pickup,Gluttony,Quick Feet,38,30,41,30,41,60,240,0.5,0.5,,Field,,38.6,1.04,60,82,3
264,264,Linoone,0,Normal,,Pickup,Gluttony,Quick Feet,78,70,61,50,61,100,420,0.5,0.5,Zigzagoon,Field,,71.6,1.08,120,122,3
265,265,Wurmple,0,Bug,,Shield Dust,,Run Away,45,45,35,20,30,20,195,0.5,0.5,,Bug,,7.9,1,65,65,3
266,266,Silcoon,0,Bug,,Shed Skin,,,50,35,55,25,25,15,205,0.5,0.5,Wurmple,Bug,,22,2,60,80,3
267,267,Beautifly,0,Bug,Flying,Swarm,,Rivalry,60,70,50,100,50,65,395,0.5,0.5,Silcoon,Bug,,62.6,3.03,170,100,3
268,268,Cascoon,0,Bug,,Shed Skin,,,50,35,55,25,25,15,205,0.5,0.5,Wumple,Bug,,25.4,2.04,60,80,3
269,269,Dustox,0,Bug,Poison,Shield Dust,,Compound Eyes,60,50,70,50,90,65,385,0.5,0.5,Cascoon,Bug,,69.7,3.11,100,160,3
270,270,Lotad,0,Water,Grass,Swift Swim,Rain Dish,Own Tempo,40,30,30,40,50,30,220,0.5,0.5,,Water 1,Grass,5.7,1.08,70,80,3
271,271,Lombre,0,Water,Grass,Swift Swim,Rain Dish,Own Tempo,60,50,50,60,70,50,340,0.5,0.5,Lotad,Water 1,Grass,71.6,3.11,110,120,3
272,272,Ludicolo,0,Water,Grass,Swift Swim,Rain Dish,Own Tempo,80,70,70,90,100,70,480,0.5,0.5,Lombre,Water 1,Grass,121.3,4.11,160,170,3
273,273,Seedot,0,Grass,,Chlorophyll,Early Bird,Pickpocket,40,40,50,30,30,30,220,0.5,0.5,,Field,Grass,8.8,1.08,70,80,3
274,274,Nuzleaf,0,Grass,Dark,Chlorophyll,Early Bird,Pickpocket,70,70,40,60,40,60,340,0.5,0.5,Seedot,Field,Grass,61.7,3.03,130,80,3
275,275,Shiftry,0,Grass,Dark,Chlorophyll,Early Bird,Pickpocket,90,100,60,90,60,80,480,0.5,0.5,Nuzleaf,Field,Grass,131.4,4.03,190,120,3
276,276,Taillow,0,Normal,Flying,Guts,,Scrappy,40,55,30,30,30,85,270,0.5,0.5,,Flying,,5.1,1,85,60,3
277,277,Swellow,0,Normal,Flying,Guts,,Scrappy,60,85,60,75,50,125,455,0.5,0.5,Taillow,Flying,,43.7,2.04,160,110,3
278,278,Wingull,0,Water,Flying,Keen Eye,Hydration,Rain Dish,40,30,30,55,30,85,270,0.5,0.5,,Water 1,Flying,20.9,2,85,60,3
279,279,Pelipper,0,Water,Flying,Keen Eye,Drizzle,Rain Dish,60,50,100,95,70,65,440,0.5,0.5,Wingull,Water 1,Flying,61.7,3.11,145,170,3
280,280,Ralts,0,Psychic,Fairy,Synchronize,Trace,Telepathy,28,25,25,45,35,40,198,0.5,0.5,,Amorphous,,14.6,1.04,70,60,3
281,281,Kirlia,0,Psychic,Fairy,Synchronize,Trace,Telepathy,38,35,35,65,55,50,278,0.5,0.5,Ralts,Amorphous,,44.5,2.07,100,90,3
282,282,Gardevoir,0,Psychic,Fairy,Synchronize,Trace,Telepathy,68,65,65,125,115,80,518,0.5,0.5,Kirlia,Amorphous,,106.7,5.03,190,180,3
283,283,Surskit,0,Bug,Water,Swift Swim,,Rain Dish,40,30,32,50,52,65,269,0.5,0.5,,Water 1,Bug,3.7,1.08,80,84,3
284,284,Masquerain,0,Bug,Flying,Intimidate,,Unnerve,70,60,62,100,82,80,454,0.5,0.5,Surskit,Water 1,Bug,7.9,2.07,160,144,3
285,285,Shroomish,0,Grass,,Effect Spore,Poison Heal,Quick Feet,60,40,60,40,60,35,295,0.5,0.5,,Fairy,Grass,9.9,1.04,80,120,3
286,286,Breloom,0,Grass,Fighting,Effect Spore,Poison Heal,Technician,60,130,80,60,60,70,460,0.5,0.5,Shroomish,Fairy,Grass,86.4,3.11,190,140,3
287,287,Slakoth,0,Normal,,Truant,,,60,60,60,35,35,30,280,0.5,0.5,,Field,,52.9,2.07,95,95,3
288,288,Vigoroth,0,Normal,,Vital Spirit,,,80,80,80,55,55,90,440,0.5,0.5,Slakoth,Field,,102.5,4.07,135,135,3
289,289,Slaking,0,Normal,,Truant,,,150,160,100,95,65,100,670,0.5,0.5,Vigoroth,Field,,287.7,6.07,255,165,3
290,290,Nincada,0,Bug,Ground,Compound Eyes,,Run Away,31,45,90,30,30,40,266,0.5,0.5,,Bug,,12.1,1.08,75,120,3
291,291,Ninjask,0,Bug,Flying,Speed Boost,,Infiltrator,61,90,45,50,50,160,456,0.5,0.5,Nincada,Bug,,26.5,2.07,140,95,3
292,292,Shedinja,0,Bug,Ghost,Wonder Guard,,Wonder Guard,1,90,45,30,30,40,236,NA,NA,Nincada,Mineral,,2.6,2.07,120,75,3
293,293,Whismur,0,Normal,,Soundproof,,Rattled,64,51,23,51,23,28,240,0.5,0.5,,Monster,Field,35.9,2,102,46,3
294,294,Loudred,0,Normal,,Soundproof,,Scrappy,84,71,43,71,43,48,360,0.5,0.5,Whismur,Monster,Field,89.3,3.03,142,86,3
295,295,Exploud,0,Normal,,Soundproof,,Scrappy,104,91,63,91,73,68,490,0.5,0.5,Loudred,Monster,Field,185.2,4.11,182,136,3
296,296,Makuhita,0,Fighting,,Thick Fat,Guts,Sheer Force,72,60,30,20,30,25,237,0.5,0.5,,Human-Like,,190.5,3.03,80,60,3
297,297,Hariyama,0,Fighting,,Thick Fat,Guts,Sheer Force,144,120,60,40,60,50,474,0.5,0.5,Makuhita,Human-Like,,559.5,7.07,160,120,3
298,298,Azurill,0,Normal,Fairy,Thick Fat,Huge Power,Sap Sipper,50,20,40,20,40,20,190,0.25,0.75,,Undiscovered,,4.4,0.08,40,80,3
299,299,Nosepass,0,Rock,,Sturdy,Magnet Pull,Sand Force,30,45,135,45,90,30,375,0.5,0.5,,Mineral,,213.8,3.03,90,225,3
300,300,Skitty,0,Normal,,Cute Charm,Normalize,Wonder Skin,50,45,45,35,35,50,260,0.25,0.75,,Field,Fairy,24.3,2,80,80,3
301,301,Delcatty,0,Normal,,Cute Charm,Normalize,Wonder Skin,70,65,65,55,55,90,400,0.25,0.75,Skitty,Field,Fairy,71.9,3.07,120,120,3
302,302,Sableye,0,Dark,Ghost,Keen Eye,Stall,Prankster,50,75,75,65,65,50,380,0.5,0.5,,Human-Like,,24.3,1.08,140,140,3
303,303,Mawile,0,Steel,Fairy,Hyper Cutter,Intimidate,Sheer Force,50,85,85,55,55,50,380,0.5,0.5,,Field,Fairy,25.4,2,140,140,3
304,304,Aron,0,Steel,Rock,Sturdy,Rock Head,Heavy Metal,50,70,100,40,40,30,330,0.5,0.5,,Monster,,132.3,1.04,110,140,3
305,305,Lairon,0,Steel,Rock,Sturdy,Rock Head,Heavy Metal,60,90,140,50,50,40,430,0.5,0.5,Aron,Monster,,264.6,2.11,140,190,3
306,306,Aggron,0,Steel,Rock,Sturdy,Rock Head,Heavy Metal,70,110,180,60,60,50,530,0.5,0.5,Lairon,Monster,,793.7,6.11,170,240,3
307,307,Meditite,0,Fighting,Psychic,Pure Power,,Telepathy,30,40,55,40,55,60,280,0.5,0.5,,Human-Like,,24.7,2,80,110,3
308,308,Medicham,0,Fighting,Psychic,Pure Power,,Telepathy,60,60,75,60,75,80,410,0.5,0.5,Meditite,Human-Like,,69.4,4.03,120,150,3
309,309,Electrike,0,Electric,,Static,Lightning Rod,Minus,40,45,40,65,40,65,295,0.5,0.5,,Field,,33.5,2,110,80,3
310,310,Manectric,0,Electric,,Static,Lightning Rod,Minus,70,75,60,105,60,105,475,0.5,0.5,Electrike,Field,,88.6,4.11,180,120,3
311,311,Plusle,0,Electric,,Plus,,Lightning Rod,60,50,40,85,75,95,405,0.5,0.5,,Fairy,,9.3,1.04,135,115,3
312,312,Minun,0,Electric,,Minus,,Volt Absorb,60,40,50,75,85,95,405,0.5,0.5,,Fairy,,9.3,1.04,115,135,3
313,313,Volbeat,0,Bug,,Illuminate,Swarm,Prankster,65,73,75,47,85,85,430,1,0,,Bug,Human-Like,39,2.04,120,160,3
314,314,Illumise,0,Bug,,Oblivious,Tinted Lens,Prankster,65,47,75,73,85,85,430,0,1,,Bug,Human-Like,39,2,120,160,3
315,315,Roselia,0,Grass,Poison,Natural Cure,Poison Point,Leaf Guard,50,60,45,100,80,65,400,0.5,0.5,Budew,Fairy,Grass,4.4,1,160,125,3
316,316,Gulpin,0,Poison,,Liquid Ooze,Sticky Hold,Gluttony,70,43,53,43,53,40,302,0.5,0.5,,Amorphous,,22.7,1.04,86,106,3
317,317,Swalot,0,Poison,,Liquid Ooze,Sticky Hold,Gluttony,100,73,83,73,83,55,467,0.5,0.5,Gulpin,Amorphous,,176.4,5.07,146,166,3
318,318,Carvanha,0,Water,Dark,Rough Skin,,Speed Boost,45,90,20,65,20,65,305,0.5,0.5,,Water 2,,45.9,2.07,155,40,3
319,319,Sharpedo,0,Water,Dark,Rough Skin,,Speed Boost,70,120,40,95,40,95,460,0.5,0.5,Carvanha,Water 2,,195.8,5.11,215,80,3
320,320,Wailmer,0,Water,,Water Veil,Oblivious,Pressure,130,70,35,70,35,60,400,0.5,0.5,,Field,Water 2,286.6,6.07,140,70,3
321,321,Wailord,0,Water,,Water Veil,Oblivious,Pressure,170,90,45,90,45,60,500,0.5,0.5,Wailmer,Field,Water 2,877.4,47.07,180,90,3
322,322,Numel,0,Fire,Ground,Oblivious,Simple,Own Tempo,60,60,40,65,45,35,305,0.5,0.5,,Field,,52.9,2.04,125,85,3
323,323,Camerupt,0,Fire,Ground,Magma Armor,Solid Rock,Anger Point,70,100,70,105,75,40,460,0.5,0.5,Numel,Field,,485,6.03,205,145,3
324,324,Torkoal,0,Fire,,White Smoke,Drought,Shell Armor,70,85,140,85,70,20,470,0.5,0.5,,Field,,177.2,1.08,170,210,3
325,325,Spoink,0,Psychic,,Thick Fat,Own Tempo,Gluttony,60,25,35,70,80,60,330,0.5,0.5,,Field,,67.5,2.04,95,115,3
326,326,Grumpig,0,Psychic,,Thick Fat,Own Tempo,Gluttony,80,45,65,90,110,80,470,0.5,0.5,Spoink,Field,,157.6,2.11,135,175,3
327,327,Spinda,0,Normal,,Own Tempo,Tangled Feet,Contrary,60,60,60,60,60,60,360,0.5,0.5,,Field,Human-Like,11,3.07,120,120,3
328,328,Trapinch,0,Ground,,Hyper Cutter,Arena Trap,Sheer Force,45,100,45,45,45,10,290,0.5,0.5,,Bug,,33.1,2.04,145,90,3
329,329,Vibrava,0,Ground,Dragon,Levitate,,,50,70,50,50,50,70,340,0.5,0.5,Trapinch,Bug,,33.7,3.07,120,100,3
330,330,Flygon,0,Ground,Dragon,Levitate,,,80,100,80,80,80,100,520,0.5,0.5,Vibrava,Bug,,180.8,6.07,180,160,3
331,331,Cacnea,0,Grass,,Sand Veil,,Water Absorb,50,85,40,85,40,35,335,0.5,0.5,,Grass,Human-Like,113.1,1.04,170,80,3
332,332,Cacturne,0,Grass,Dark,Sand Veil,,Water Absorb,70,115,60,115,60,55,475,0.5,0.5,Cacnea,Grass,Human-Like,170.6,4.03,230,120,3
333,333,Swablu,0,Normal,Flying,Natural Cure,,Cloud Nine,45,40,60,40,75,50,310,0.5,0.5,,Flying,Dragon,2.6,1.04,80,135,3
334,334,Altaria,0,Dragon,Flying,Natural Cure,,Cloud Nine,75,70,90,70,105,80,490,0.5,0.5,Swablu,Flying,Dragon,45.4,3.07,140,195,3
335,335,Zangoose,0,Normal,,Immunity,,Toxic Boost,73,115,60,60,60,90,458,0.5,0.5,,Field,,88.8,4.03,175,120,3
336,336,Seviper,0,Poison,,Shed Skin,,Infiltrator,73,100,60,100,60,65,458,0.5,0.5,,Field,Dragon,115.7,8.1,200,120,3
337,337,Lunatone,0,Rock,Psychic,Levitate,,,90,55,65,95,85,70,460,NA,NA,,Mineral,,370.4,3.03,150,150,3
338,338,Solrock,0,Rock,Psychic,Levitate,,,90,95,85,55,65,70,460,NA,NA,,Mineral,,339.5,3.11,150,150,3
339,339,Barboach,0,Water,Ground,Oblivious,Anticipation,Hydration,50,48,43,46,41,60,288,0.5,0.5,,Water 2,,4.2,1.04,94,84,3
340,340,Whiscash,0,Water,Ground,Oblivious,Anticipation,Hydration,110,78,73,76,71,60,468,0.5,0.5,Barboach,Water 2,,52,2.11,154,144,3
341,341,Corphish,0,Water,,Hyper Cutter,Shell Armor,Adaptability,43,80,65,50,35,35,308,0.5,0.5,,Water 1,Water 3,25.4,2,130,100,3
342,342,Crawdaunt,0,Water,Dark,Hyper Cutter,Shell Armor,Adaptability,63,120,85,90,55,55,468,0.5,0.5,Corphish,Water 1,Water 3,72.3,3.07,210,140,3
343,343,Baltoy,0,Ground,Psychic,Levitate,,,40,40,55,40,70,55,300,NA,NA,,Mineral,,47.4,1.08,80,125,3
344,344,Claydol,0,Ground,Psychic,Levitate,,,60,70,105,70,120,75,500,NA,NA,Baltoy,Mineral,,238.1,4.11,140,225,3
345,345,Lileep,0,Rock,Grass,Suction Cups,,Storm Drain,66,41,77,61,87,23,355,0.875,0.125,,Water 3,,52.5,3.03,102,164,3
346,346,Cradily,0,Rock,Grass,Suction Cups,,Storm Drain,86,81,97,81,107,43,495,0.875,0.125,Lileep,Water 3,,133.2,4.11,162,204,3
347,347,Anorith,0,Rock,Bug,Battle Armor,,Swift Swim,45,95,50,40,50,75,355,0.875,0.125,,Water 3,,27.6,2.04,135,100,3
348,348,Armaldo,0,Rock,Bug,Battle Armor,,Swift Swim,75,125,100,70,80,45,495,0.875,0.125,Anorith,Water 3,,150.4,4.11,195,180,3
349,349,Feebas,0,Water,,Swift Swim,Oblivious,Adaptability,20,15,20,10,55,80,200,0.5,0.5,,Water 1,Dragon,16.3,2,25,75,3
350,350,Milotic,0,Water,,Marvel Scale,Competitive,Cute Charm,95,60,79,100,125,81,540,0.5,0.5,Feebas,Water 1,Dragon,357.1,20.04,160,204,3
351,351,Castform,0,Normal,,Forecast,,,70,70,70,70,70,70,420,0.5,0.5,,Fairy,Amorphous,1.8,1,140,140,3
352,352,Kecleon,0,Normal,,Color Change,,Protean,60,90,70,60,120,40,440,0.5,0.5,,Field,,48.5,3.03,150,190,3
353,353,Shuppet,0,Ghost,,Insomnia,Frisk,Cursed Body,44,75,35,63,33,45,295,0.5,0.5,,Amorphous,,5.1,2,138,68,3
354,354,Banette,0,Ghost,,Insomnia,Frisk,Cursed Body,64,115,65,83,63,65,455,0.5,0.5,Shuppet,Amorphous,,27.6,3.07,198,128,3
355,355,Duskull,0,Ghost,,Levitate,,Frisk,20,40,90,30,90,25,295,0.5,0.5,,Amorphous,,33.1,2.07,70,180,3
356,356,Dusclops,0,Ghost,,Pressure,,Frisk,40,70,130,60,130,25,455,0.5,0.5,Duskull,Amorphous,,67.5,5.03,130,260,3
357,357,Tropius,0,Grass,Flying,Chlorophyll,Solar Power,Harvest,99,68,83,72,87,51,460,0.5,0.5,,Monster,Grass,220.5,6.07,140,170,3
358,358,Chimecho,0,Psychic,,Levitate,,,75,50,80,95,90,65,455,0.5,0.5,Chingling,Amorphous,,2.2,2,145,170,3
359,359,Absol,0,Dark,,Pressure,Super Luck,Justified,65,130,60,75,60,75,465,0.5,0.5,,Field,,103.6,3.11,205,120,3
360,360,Wynaut,0,Psychic,,Shadow Tag,,Telepathy,95,23,48,23,48,23,260,0.5,0.5,,Undiscovered,,30.9,2,46,96,3
361,361,Snorunt,0,Ice,,Inner Focus,Ice Body,Moody,50,50,50,50,50,50,300,0.5,0.5,,Fairy,Mineral,37,2.04,100,100,3
362,362,Glalie,0,Ice,,Inner Focus,Ice Body,Moody,80,80,80,80,80,80,480,0.5,0.5,Snorunt,Fairy,Mineral,565.5,4.11,160,160,3
363,363,Spheal,0,Ice,Water,Thick Fat,Ice Body,Oblivious,70,40,50,55,50,25,290,0.5,0.5,,Water 1,Field,87.1,2.07,95,100,3
364,364,Sealeo,0,Ice,Water,Thick Fat,Ice Body,Oblivious,90,60,70,75,70,45,410,0.5,0.5,Spheal,Water 1,Field,193.1,3.07,135,140,3
365,365,Walrein,0,Ice,Water,Thick Fat,Ice Body,Oblivious,110,80,90,95,90,65,530,0.5,0.5,Sealeo,Water 1,Field,332,4.07,175,180,3
366,366,Clamperl,0,Water,,Shell Armor,,Rattled,35,64,85,74,55,32,345,0.5,0.5,,Water 1,,115.7,1.04,138,140,3
367,367,Huntail,0,Water,,Swift Swim,,Water Veil,55,104,105,94,75,52,485,0.5,0.5,Clamperl,Water 1,,59.5,5.07,198,180,3
368,368,Gorebyss,0,Water,,Swift Swim,,Hydration,55,84,105,114,75,52,485,0.5,0.5,Clamperl,Water 1,,49.8,5.11,198,180,3
369,369,Relicanth,0,Water,Rock,Swift Swim,Rock Head,Sturdy,100,90,130,45,65,55,485,0.5,0.5,,Water 1,Water 2,51.6,3.03,135,195,3
370,370,Luvdisc,0,Water,,Swift Swim,,Hydration,43,30,55,40,65,97,330,0.25,0.75,,Water 2,,19.2,2,70,120,3
371,371,Bagon,0,Dragon,,Rock Head,,Sheer Force,45,75,60,40,30,50,300,0.5,0.5,,Dragon,,92.8,2,115,90,3
372,372,Shelgon,0,Dragon,,Rock Head,,Overcoat,65,95,100,60,50,50,420,0.5,0.5,Bagon,Dragon,,243.6,3.07,155,150,3
373,373,Salamence,0,Dragon,Flying,Intimidate,,Moxie,95,135,80,110,80,100,600,0.5,0.5,Shelgon,Dragon,,226.2,4.11,245,160,3
374,374,Beldum,0,Steel,Psychic,Clear Body,,Light Metal,40,55,80,35,60,30,300,NA,NA,,Mineral,,209.9,2,90,140,3
375,375,Metang,0,Steel,Psychic,Clear Body,,Light Metal,60,75,100,55,80,50,420,NA,NA,Beldum,Mineral,,446.4,3.11,130,180,3
376,376,Metagross,0,Steel,Psychic,Clear Body,,Light Metal,80,135,130,95,90,70,600,NA,NA,Metang,Mineral,,1212.5,5.03,230,220,3
377,377,Regirock,0,Rock,,Clear Body,,Sturdy,80,100,200,50,100,50,580,NA,NA,,Undiscovered,,507.1,5.07,150,300,3
378,378,Regice,0,Ice,,Clear Body,,Ice Body,80,50,100,100,200,50,580,NA,NA,,Undiscovered,,385.8,5.11,150,300,3
379,379,Registeel,0,Steel,,Clear Body,,Light Metal,80,75,150,75,150,50,580,NA,NA,,Undiscovered,,451.9,6.03,150,300,3
380,380,Latias,0,Dragon,Psychic,Levitate,,,80,80,90,110,130,110,600,0,1,,Undiscovered,,88.2,4.07,190,220,3
381,381,Latios,0,Dragon,Psychic,Levitate,,,80,90,80,130,110,110,600,1,0,,Undiscovered,,132.3,6.07,220,190,3
382,382,Kyogre,0,Water,,Drizzle,,,100,100,90,150,140,90,670,NA,NA,,Undiscovered,,776,14.09,250,230,3
383,383,Groudon,0,Ground,,Drought,,,100,150,140,100,90,90,670,NA,NA,,Undiscovered,,2094.4,11.06,250,230,3
384,384,Rayquaza,0,Dragon,Flying,Air Lock,,,105,150,90,150,90,95,680,NA,NA,,Undiscovered,,455.2,23,300,180,3
385,385,Jirachi,0,Steel,Psychic,Serene Grace,,,100,100,100,100,100,100,600,NA,NA,,Undiscovered,,2.4,1,200,200,3
386,386,Deoxys,0,Psychic,,Pressure,,,50,150,50,150,50,150,600,NA,NA,,Undiscovered,,134,5.07,300,100,3
387,387,Turtwig,0,Grass,,Overgrow,,Shell Armor,55,68,64,45,55,31,318,0.875,0.125,,Monster,Grass,22.5,1.04,113,119,4
388,388,Grotle,0,Grass,,Overgrow,,Shell Armor,75,89,85,55,65,36,405,0.875,0.125,Turtwig,Monster,Grass,213.8,3.07,144,150,4
389,389,Torterra,0,Grass,Ground,Overgrow,,Shell Armor,95,109,105,75,85,56,525,0.875,0.125,Grotle,Monster,Grass,683.4,7.03,184,190,4
390,390,Chimchar,0,Fire,,Blaze,,Iron Fist,44,58,44,58,44,61,309,0.875,0.125,,Field,Human-Like,13.7,1.08,116,88,4
391,391,Monferno,0,Fire,Fighting,Blaze,,Iron Fist,64,78,52,78,52,81,405,0.875,0.125,Chimchar,Field,Human-Like,48.5,2.11,156,104,4
392,392,Infernape,0,Fire,Fighting,Blaze,,Iron Fist,76,104,71,104,71,108,534,0.875,0.125,Monferno,Field,Human-Like,121.3,3.11,208,142,4
393,393,Piplup,0,Water,,Torrent,,Defiant,53,51,53,61,56,40,314,0.875,0.125,,Water 1,Field,11.5,1.04,112,109,4
394,394,Prinplup,0,Water,,Torrent,,Defiant,64,66,68,81,76,50,405,0.875,0.125,Piplup,Water 1,Field,50.7,2.07,147,144,4
395,395,Empoleon,0,Water,Steel,Torrent,,Defiant,84,86,88,111,101,60,530,0.875,0.125,Prinplup,Water 1,Field,186.3,5.07,197,189,4
396,396,Starly,0,Normal,Flying,Keen Eye,,Reckless,40,55,30,30,30,60,245,0.5,0.5,,Flying,,4.4,1,85,60,4
397,397,Staravia,0,Normal,Flying,Intimidate,,Reckless,55,75,50,40,40,80,340,0.5,0.5,Starly,Flying,,34.2,2,115,90,4
398,398,Staraptor,0,Normal,Flying,Intimidate,,Reckless,85,120,70,50,60,100,485,0.5,0.5,Staravia,Flying,,54.9,3.11,170,130,4
399,399,Bidoof,0,Normal,,Simple,Unaware,Moody,59,45,40,35,40,31,250,0.5,0.5,,Water 1,Field,44.1,1.08,80,80,4
400,400,Bibarel,0,Normal,Water,Simple,Unaware,Moody,79,85,60,55,60,71,410,0.5,0.5,Bidoof,Water 1,Field,69.4,3.03,140,120,4
401,401,Kricketot,0,Bug,,Shed Skin,,Run Away,37,25,41,25,41,25,194,0.5,0.5,,Bug,,4.9,1,50,82,4
402,402,Kricketune,0,Bug,,Swarm,,Technician,77,85,51,55,51,65,384,0.5,0.5,Kricketot,Bug,,56.2,3.03,140,102,4
403,403,Shinx,0,Electric,,Rivalry,Intimidate,Guts,45,65,34,40,34,45,263,0.5,0.5,,Field,,20.9,1.08,105,68,4
404,404,Luxio,0,Electric,,Rivalry,Intimidate,Guts,60,85,49,60,49,60,363,0.5,0.5,Shinx,Field,,67.2,2.11,145,98,4
405,405,Luxray,0,Electric,,Rivalry,Intimidate,Guts,80,120,79,95,79,70,523,0.5,0.5,Luxio,Field,,92.6,4.07,215,158,4
406,406,Budew,0,Grass,Poison,Mold Breaker,,Sheer Force,40,30,35,50,70,55,280,0.5,0.5,,Undiscovered,,2.6,0.08,80,105,4
407,407,Roserade,0,Grass,Poison,Mold Breaker,,Sheer Force,60,70,65,125,105,90,515,0.5,0.5,Roselia,Fairy,Grass,32,2.11,195,170,4
408,408,Cranidos,0,Rock,,Sturdy,,Soundproof,67,125,40,30,30,58,350,0.875,0.125,,Monster,,69.4,2.11,155,70,4
409,409,Rampardos,0,Rock,,Sturdy,,Soundproof,97,165,60,65,50,58,495,0.875,0.125,Cranidos,Monster,,226,5.03,230,110,4
410,410,Shieldon,0,Rock,Steel,Shed Skin,,Overcoat,30,42,118,42,88,30,350,0.875,0.125,,Monster,,125.7,1.08,84,206,4
411,411,Bastiodon,0,Rock,Steel,Shed Skin,,Overcoat,60,52,168,47,138,30,495,0.875,0.125,Shieldon,Monster,,329.6,4.03,99,306,4
412,412,Burmy,0,Bug,,Shed Skin,,Overcoat,40,29,45,29,45,36,224,0.5,0.5,,Bug,,7.5,0.08,58,90,4
413,413,Wormadam,0,Bug,Grass,Anticipation,,Overcoat,60,59,85,79,105,36,424,0,1,Burmy,Bug,,14.3,1.08,138,190,4
414,414,Mothim,0,Bug,Flying,Swarm,,Tinted Lens,70,94,50,94,50,66,424,1,0,Burmy,Bug,,51.4,2.11,188,100,4
415,415,Combee,0,Bug,Flying,Honey Gather,,Hustle,30,30,42,30,42,70,244,0.875,0.125,,Bug,,12.1,1,60,84,4
416,416,Vespiquen,0,Bug,Flying,Pressure,,Unnerve,70,80,102,80,102,40,474,0,1,Combee,Bug,,84.9,3.11,160,204,4
417,417,Pachirisu,0,Electric,,Run Away,Pickup,Volt Absorb,60,45,70,45,90,95,405,0.5,0.5,,Field,Fairy,8.6,1.04,90,160,4
418,418,Buizel,0,Water,,Swift Swim,,Water Veil,55,65,35,60,30,85,330,0.5,0.5,,Water 1,Field,65,2.04,125,65,4
419,419,Floatzel,0,Water,,Swift Swim,,Water Veil,85,105,55,85,50,115,495,0.5,0.5,Buizel,Water 1,Field,73.9,3.07,190,105,4
420,420,Cherubi,0,Grass,,Chlorophyll,,,45,35,45,62,53,35,275,0.5,0.5,,Fairy,Grass,7.3,1.04,97,98,4
421,421,Cherrim,0,Grass,,Flower Gift,,,70,60,70,87,78,85,450,0.5,0.5,Cherubi,Fairy,Grass,20.5,1.08,147,148,4
422,422,Shellos,0,Water,,Sticky Hold,Storm Drain,Sand Force,76,48,48,57,62,34,325,0.5,0.5,,Water 1,Amorphous,13.9,1,105,110,4
423,423,Gastrodon,0,Water,Ground,Sticky Hold,Storm Drain,Sand Force,111,83,68,92,82,39,475,0.5,0.5,Shellos,Water 1,Amorphous,65.9,2.11,175,150,4
424,424,Ambipom,0,Normal,,Technician,Pickup,Skill Link,75,100,66,60,66,115,482,0.5,0.5,Aipom,Field,,44.8,3.11,160,132,4
425,425,Drifloon,0,Ghost,Flying,Aftermath,Unburden,Flare Boost,90,50,34,60,44,70,348,0.5,0.5,,Amorphous,,2.6,1.04,110,78,4
426,426,Drifblim,0,Ghost,Flying,Aftermath,Unburden,Flare Boost,150,80,44,90,54,80,498,0.5,0.5,Drifloon,Amorphous,,33.1,3.11,170,98,4
427,427,Buneary,0,Normal,,Run Away,Klutz,Limber,55,66,44,44,56,85,350,0.5,0.5,,Field,Human-Like,12.1,1.04,110,100,4
428,428,Lopunny,0,Normal,,Cute Charm,Klutz,Limber,65,76,84,54,96,105,480,0.5,0.5,Buneary,Field,Human-Like,73.4,3.11,130,180,4
429,429,Mismagius,0,Ghost,,Levitate,,,60,60,60,105,105,105,495,0.5,0.5,Misdreavus,Amorphous,,9.7,2.11,165,165,4
430,430,Honchkrow,0,Dark,Flying,Insomnia,Super Luck,Moxie,100,125,52,105,52,71,505,0.5,0.5,Murkrow,Flying,,60.2,2.11,230,104,4
431,431,Glameow,0,Normal,,Limber,Own Tempo,Keen Eye,49,55,42,42,37,85,310,0.25,0.75,,Field,,8.6,1.08,97,79,4
432,432,Purugly,0,Normal,,Thick Fat,Own Tempo,Defiant,71,82,64,64,59,112,452,0.25,0.75,Glameow,Field,,96.6,3.03,146,123,4
433,433,Chingling,0,Psychic,,Levitate,,,45,30,50,65,50,45,285,0.5,0.5,,Undiscovered,,1.3,0.08,95,100,4
434,434,Stunky,0,Poison,Dark,Stench,Aftermath,Keen Eye,63,63,47,41,41,74,329,0.5,0.5,,Field,,42.3,1.04,104,88,4
435,435,Skuntank,0,Poison,Dark,Stench,Aftermath,Keen Eye,103,93,67,71,61,84,479,0.5,0.5,Stunky,Field,,83.8,3.03,164,128,4
436,436,Bronzor,0,Steel,Psychic,Levitate,Heatproof,Heavy Metal,57,24,86,24,86,23,300,NA,NA,,Mineral,,133.4,1.08,48,172,4
437,437,Bronzong,0,Steel,Psychic,Levitate,Heatproof,Heavy Metal,67,89,116,79,116,33,500,NA,NA,Bronzor,Mineral,,412.3,4.03,168,232,4
438,438,Bonsly,0,Rock,,Sturdy,Rock Head,Rattled,50,80,95,10,45,10,290,0.5,0.5,,Undiscovered,,33.1,1.08,90,140,4
439,439,Mime Jr.,0,Psychic,Fairy,Soundproof,Filter,Technician,20,25,45,70,90,60,310,0.5,0.5,,Undiscovered,,28.7,2,95,135,4
440,440,Happiny,0,Normal,,Natural Cure,Serene Grace,Friend Guard,100,5,5,15,65,30,220,0,1,,Undiscovered,,53.8,2,20,70,4
441,441,Chatot,0,Normal,Flying,Keen Eye,Tangled Feet,Big Pecks,76,65,45,92,42,91,411,0.5,0.5,,Flying,,4.2,1.08,157,87,4
442,442,Spiritomb,0,Ghost,,Pressure,,Infiltrator,50,92,108,92,108,35,485,0.5,0.5,,Amorphous,,238.1,3.03,184,216,4
443,443,Gible,0,Dragon,Ground,Sand Veil,,Rough Skin,58,70,45,40,45,42,300,0.5,0.5,,Monster,Dragon,45.2,2.04,110,90,4
444,444,Gabite,0,Dragon,Ground,Sand Veil,,Rough Skin,68,90,65,50,55,82,410,0.5,0.5,Gible,Monster,Dragon,123.5,4.07,140,120,4
445,445,Garchomp,0,Dragon,Ground,Sand Veil,,Rough Skin,108,130,95,80,85,102,600,0.5,0.5,Gabite,Monster,Dragon,209.4,6.03,210,180,4
446,446,Munchlax,0,Normal,,Pickup,Thick Fat,Gluttony,135,85,40,40,85,5,390,0.875,0.125,,Undiscovered,,231.5,2,125,125,4
447,447,Riolu,0,Fighting,,Steadfast,Inner Focus,Prankster,40,70,40,35,40,60,285,0.875,0.125,,Undiscovered,,44.5,2.04,105,80,4
448,448,Lucario,0,Fighting,Steel,Steadfast,Inner Focus,Justified,70,110,70,115,70,90,525,0.875,0.125,Riolu,Field,Human-Like,119,3.11,225,140,4
449,449,Hippopotas,0,Ground,,Sand Stream,,Sand Force,68,72,78,38,42,32,330,0.5,0.5,,Field,,109.1,2.07,110,120,4
450,450,Hippowdon,0,Ground,,Sand Stream,,Sand Force,108,112,118,68,72,47,525,0.5,0.5,Hippopotas,Field,,661.4,6.07,180,190,4
451,451,Skorupi,0,Poison,Bug,Battle Armor,Sniper,Keen Eye,40,50,90,30,55,65,330,0.5,0.5,,Bug,Water 3,26.5,2.07,80,145,4
452,452,Drapion,0,Poison,Dark,Battle Armor,Sniper,Keen Eye,70,90,110,60,75,95,500,0.5,0.5,Skorupi,Bug,Water 3,135.6,4.03,150,185,4
453,453,Croagunk,0,Poison,Fighting,Anticipation,Dry Skin,Poison Touch,48,61,40,61,40,50,300,0.5,0.5,,Human-Like,,50.7,2.04,122,80,4
454,454,Toxicroak,0,Poison,Fighting,Anticipation,Dry Skin,Poison Touch,83,106,65,86,65,85,490,0.5,0.5,Croagunk,Human-Like,,97.9,4.03,192,130,4
455,455,Carnivine,0,Grass,,Levitate,,,74,100,72,90,72,46,454,0.5,0.5,,Grass,,59.5,4.07,190,144,4
456,456,Finneon,0,Water,,Swift Swim,Storm Drain,Water Veil,49,49,56,49,61,66,330,0.5,0.5,,Water 2,,15.4,1.04,98,117,4
457,457,Lumineon,0,Water,,Swift Swim,Storm Drain,Water Veil,69,69,76,69,86,91,460,0.5,0.5,Finneon,Water 2,,52.9,3.11,138,162,4
458,458,Mantyke,0,Water,Flying,Swift Swim,Water Absorb,Water Veil,45,20,50,60,120,50,345,0.5,0.5,,Undiscovered,,143.3,3.03,80,170,4
459,459,Snover,0,Grass,Ice,Snow Warning,,Soundproof,60,62,50,62,60,40,334,0.5,0.5,,Monster,Grass,111.3,3.03,124,110,4
460,460,Abomasnow,0,Grass,Ice,Snow Warning,,Soundproof,90,92,75,92,85,60,494,0.5,0.5,Snover,Monster,Grass,298.7,7.03,184,160,4
461,461,Weavile,0,Dark,Ice,Pressure,,Pickpocket,70,120,65,45,85,125,510,0.5,0.5,Sneasel,Field,,75,3.07,165,150,4
462,462,Magnezone,0,Electric,Steel,Magnet Pull,Sturdy,Analytic,70,70,115,130,90,60,535,0.5,0.5,Magneton,Mineral,,396.8,3.11,200,205,4
463,463,Lickilicky,0,Normal,,Own Tempo,Oblivious,Cloud Nine,110,85,95,80,95,50,515,0.5,0.5,Lickitung,Monster,,308.6,5.07,165,190,4
464,464,Rhyperior,0,Ground,Rock,Lightning Rod,Solid Rock,Reckless,115,140,130,55,55,40,535,0.5,0.5,Rhydon,Monster,Field,623.5,7.1,195,185,4
465,465,Tangrowth,0,Grass,,Chlorophyll,Leaf Guard,Regenerator,100,100,125,110,50,50,535,0.5,0.5,Tangela,Grass,,283.5,6.07,210,175,4
466,466,Electivire,0,Electric,,Motor Drive,,Vital Spirit,75,123,67,95,85,95,540,0.5,0.5,Electabuzz,Human-Like,,305.6,5.11,218,152,4
467,467,Magmortar,0,Fire,,Flame Body,,Vital Spirit,75,95,67,125,95,83,540,0.5,0.5,Magmar,Human-Like,,149.9,5.03,220,162,4
468,468,Togekiss,0,Fairy,Flying,Hustle,Serene Grace,Super Luck,85,50,95,120,115,80,545,0.875,0.125,Togetic,Flying,Fairy,83.8,4.11,170,210,4
469,469,Yanmega,0,Bug,Flying,Speed Boost,Tinted Lens,Frisk,86,76,86,116,56,95,515,0.5,0.5,Yanma,Bug,,113.5,6.03,192,142,4
470,470,Leafeon,0,Grass,,Leaf Guard,,Chlorophyll,65,110,130,60,65,95,525,0.875,0.125,Eevee,Field,,56.2,3.03,170,195,4
471,471,Glaceon,0,Ice,,Snow Cloak,,Ice Body,65,60,110,130,95,65,525,0.875,0.125,Eevee,Field,,57.1,2.07,190,205,4
472,472,Gliscor,0,Ground,Flying,Hyper Cutter,Sand Veil,Poison Heal,75,95,125,45,75,95,510,0.5,0.5,Gligar,Bug,,93.7,6.07,140,200,4
473,473,Mamoswine,0,Ice,Ground,Oblivious,Snow Cloak,Thick Fat,110,130,80,70,60,80,530,0.5,0.5,Piloswine,Field,,641.5,8.02,200,140,4
474,474,Porygon-Z,0,Normal,,Adaptability,Download,Analytic,85,80,70,135,75,90,535,NA,NA,Porygon2,Mineral,,75,2.11,215,145,4
475,475,Gallade,0,Psychic,Fighting,Steadfast,,Justified,68,125,65,65,115,80,518,1,0,Kirlia,Amorphous,,114.6,5.03,190,180,4
476,476,Probopass,0,Rock,Steel,Sturdy,Magnet Pull,Sand Force,60,55,145,75,150,40,525,0.5,0.5,Nosepass,Mineral,,749.6,4.07,130,295,4
477,477,Dusknoir,0,Ghost,,Pressure,,Frisk,45,100,135,65,135,45,525,0.5,0.5,Dusclops,Amorphous,,235,7.03,165,270,4
478,478,Froslass,0,Ice,Ghost,Snow Cloak,,Cursed Body,70,80,70,80,70,110,480,0,1,Snorunt,Fairy,Mineral,58.6,4.03,160,140,4
479,479,Rotom,0,Electric,Ghost,Levitate,,,50,50,77,95,77,91,440,NA,NA,,Amorphous,,0.7,1,145,154,4
480,480,Uxie,0,Psychic,,Levitate,,,75,75,130,75,130,95,580,NA,NA,,Undiscovered,,0.7,1,150,260,4
481,481,Mesprit,0,Psychic,,Levitate,,,80,105,105,105,105,80,580,NA,NA,,Undiscovered,,0.7,1,210,210,4
482,482,Azelf,0,Psychic,,Levitate,,,75,125,70,125,70,115,580,NA,NA,,Undiscovered,,0.7,1,250,140,4
483,483,Dialga,0,Steel,Dragon,Pressure,,Telepathy,100,120,120,150,100,90,680,NA,NA,,Undiscovered,,1505.8,17.09,270,220,4
484,484,Palkia,0,Water,Dragon,Pressure,,Telepathy,90,120,100,150,120,100,680,NA,NA,,Undiscovered,,740.8,13.09,270,220,4
485,485,Heatran,0,Fire,Steel,Flash Fire,,Flame Body,91,90,106,130,106,77,600,0.5,0.5,,Undiscovered,,948,5.07,220,212,4
486,486,Regigigas,0,Normal,,Slow Start,,,110,160,110,80,110,100,670,NA,NA,,Undiscovered,,925.9,12.02,240,220,4
487,487,Giratina,0,Ghost,Dragon,Pressure,,Telepathy,150,100,120,100,120,90,680,NA,NA,,Undiscovered,,1653.5,14.09,200,240,4
488,488,Cresselia,0,Psychic,,Levitate,,,120,70,120,75,130,85,600,NA,NA,,Undiscovered,,188.7,4.11,145,250,4
489,489,Phione,0,Water,,Hydration,,,80,80,80,80,80,80,480,NA,NA,,Water 1,Fairy,6.8,1.04,160,160,4
490,490,Manaphy,0,Water,,Hydration,,,100,100,100,100,100,100,600,NA,NA,,Water 1,Fairy,3.1,1,200,200,4
491,491,Darkrai,0,Dark,,Bad Dreams,,,70,90,90,135,90,125,600,NA,NA,,Undiscovered,,111.3,4.11,225,180,4
492,492,Shaymin,0,Grass,,Natural Cure,,,100,100,100,100,100,100,600,NA,NA,,Undiscovered,,4.6,0.08,200,200,4
493,493,Arceus,0,Normal,,Multitype,,,120,120,120,120,120,120,720,NA,NA,,Undiscovered,,705.5,10.06,240,240,4
494,494,Victini,0,Psychic,Fire,Victory Star,,,100,100,100,100,100,100,600,0,1,,Undiscovered,,8.8,1.04,200,200,5
495,495,Snivy,0,Grass,,Overgrow,,Contrary,45,45,55,45,55,63,308,0.875,0.125,,Field,Grass,17.9,2,90,110,5
496,496,Servine,0,Grass,,Overgrow,,Contrary,60,60,75,60,75,83,413,0.875,0.125,Snivy,Field,Grass,35.3,2.07,120,150,5
497,497,Serperior,0,Grass,,Overgrow,,Contrary,75,75,95,75,95,113,528,0.875,0.125,Servine,Field,Grass,138.9,10.1,150,190,5
498,498,Tepig,0,Fire,,Blaze,,Thick Fat,65,63,45,45,45,45,308,0.875,0.125,,Field,,21.8,1.08,108,90,5
499,499,Pignite,0,Fire,Fighting,Blaze,,Thick Fat,90,93,55,70,55,55,418,0.875,0.125,Tepig,Field,,122.4,3.03,163,110,5
500,500,Emboar,0,Fire,Fighting,Blaze,,Reckless,110,123,65,100,65,65,528,0.875,0.125,Pignite,Field,,330.7,5.03,223,130,5
501,501,Oshawott,0,Water,,Torrent,,Shell Armor,55,55,45,63,45,45,308,0.875,0.125,,Field,,13,1.08,118,90,5
502,502,Dewott,0,Water,,Torrent,,Shell Armor,75,75,60,83,60,60,413,0.875,0.125,Oshawott,Field,,54,2.07,158,120,5
503,503,Samurott,0,Water,,Torrent,,Shell Armor,95,100,85,108,70,70,528,0.875,0.125,Dewott,Field,,208.6,4.11,208,155,5
504,504,Patrat,0,Normal,,Run Away,Keen Eye,Analytic,45,55,39,35,39,42,255,0.5,0.5,,Field,,25.6,1.08,90,78,5
505,505,Watchog,0,Normal,,Illuminate,Keen Eye,Analytic,60,85,69,60,69,77,420,0.5,0.5,Patrat,Field,,59.5,3.07,145,138,5
506,506,Lillipup,0,Normal,,Vital Spirit,Pickup,Run Away,45,60,45,25,45,55,275,0.5,0.5,,Field,,9,1.04,85,90,5
507,507,Herdier,0,Normal,,Intimidate,Sand Rush,Scrappy,65,80,65,35,65,60,370,0.5,0.5,Lillipup,Field,,32.4,2.11,115,130,5
508,508,Stoutland,0,Normal,,Intimidate,Sand Rush,Scrappy,85,110,90,45,90,80,500,0.5,0.5,Herdier,Field,,134.5,3.11,155,180,5
509,509,Purrloin,0,Dark,,Limber,Unburden,Prankster,41,50,37,50,37,66,281,0.5,0.5,,Field,,22.3,1.04,100,74,5
510,510,Liepard,0,Dark,,Limber,Unburden,Prankster,64,88,50,88,50,106,446,0.5,0.5,Purrloin,Field,,82.7,3.07,176,100,5
511,511,Pansage,0,Grass,,Gluttony,,Overgrow,50,53,48,53,48,64,316,0.875,0.125,,Field,,23.1,2,106,96,5
512,512,Simisage,0,Grass,,Gluttony,,Overgrow,75,98,63,98,63,101,498,0.875,0.125,Pansage,Field,,67.2,3.07,196,126,5
513,513,Pansear,0,Fire,,Gluttony,,Blaze,50,53,48,53,48,64,316,0.875,0.125,,Field,,24.3,2,106,96,5
514,514,Simisear,0,Fire,,Gluttony,,Blaze,75,98,63,98,63,101,498,0.875,0.125,Pansear,Field,,61.7,3.03,196,126,5
515,515,Panpour,0,Water,,Gluttony,,Torrent,50,53,48,53,48,64,316,0.875,0.125,,Field,,29.8,2,106,96,5
516,516,Simipour,0,Water,,Gluttony,,Torrent,75,98,63,98,63,101,498,0.875,0.125,Panpour,Field,,63.9,3.03,196,126,5
517,517,Munna,0,Psychic,,Forewarn,Synchronize,Telepathy,76,25,45,67,55,24,292,0.5,0.5,,Field,,51.4,2,92,100,5
518,518,Musharna,0,Psychic,,Forewarn,Synchronize,Telepathy,116,55,85,107,95,29,487,0.5,0.5,Munna,Field,,133.4,3.07,162,180,5
519,519,Pidove,0,Normal,Flying,Big Pecks,Super Luck,Rivalry,50,55,50,36,30,43,264,0.5,0.5,,Flying,,4.6,1,91,80,5
520,520,Tranquill,0,Normal,Flying,Big Pecks,Super Luck,Rivalry,62,77,62,50,42,65,358,0.5,0.5,Pidove,Flying,,33.1,2,127,104,5
521,521,Unfezant,0,Normal,Flying,Big Pecks,Super Luck,Rivalry,80,115,80,65,55,93,488,0.5,0.5,Tranquill,Flying,,63.9,3.11,180,135,5
522,522,Blitzle,0,Electric,,Lightning Rod,Motor Drive,Sap Sipper,45,60,32,50,32,76,295,0.5,0.5,,Field,,65.7,2.07,110,64,5
523,523,Zebstrika,0,Electric,,Lightning Rod,Motor Drive,Sap Sipper,75,100,63,80,63,116,497,0.5,0.5,Blitzle,Field,,175.3,5.03,180,126,5
524,524,Roggenrola,0,Rock,,Sturdy,Weak Armor,Sand Force,55,75,85,25,25,15,280,0.5,0.5,,Mineral,,39.7,1.04,100,110,5
525,525,Boldore,0,Rock,,Sturdy,Weak Armor,Sand Force,70,105,105,50,40,20,390,0.5,0.5,Roggenrola,Mineral,,224.9,2.11,155,145,5
526,526,Gigalith,0,Rock,,Sturdy,Sand Stream,Sand Force,85,135,130,60,80,25,515,0.5,0.5,Boldore,Mineral,,573.2,5.07,195,210,5
527,527,Woobat,0,Psychic,Flying,Unaware,Klutz,Simple,65,45,43,55,43,72,323,0.5,0.5,,Field,Flying,4.6,1.04,100,86,5
528,528,Swoobat,0,Psychic,Flying,Unaware,Klutz,Simple,67,57,55,77,55,114,425,0.5,0.5,Woobat,Field,Flying,23.1,2.11,134,110,5
529,529,Drilbur,0,Ground,,Sand Rush,Sand Force,Mold Breaker,60,85,40,30,45,68,328,0.5,0.5,,Field,,18.7,1,115,85,5
530,530,Excadrill,0,Ground,Steel,Sand Rush,Sand Force,Mold Breaker,110,135,60,50,65,88,508,0.5,0.5,Drilbur,Field,,89.1,2.04,185,125,5
531,531,Audino,0,Normal,,Healer,Regenerator,Klutz,103,60,86,60,86,50,445,0.5,0.5,,Fairy,,68.3,3.07,120,172,5
532,532,Timburr,0,Fighting,,Guts,Sheer Force,Iron Fist,75,80,55,25,35,35,305,0.75,0.25,,Human-Like,,27.6,2,105,90,5
533,533,Gurdurr,0,Fighting,,Guts,Sheer Force,Iron Fist,85,105,85,40,50,40,405,0.75,0.25,Timburr,Human-Like,,88.2,3.11,145,135,5
534,534,Conkeldurr,0,Fighting,,Guts,Sheer Force,Iron Fist,105,140,95,55,65,45,505,0.75,0.25,Gurdurr,Human-Like,,191.8,4.07,195,160,5
535,535,Tympole,0,Water,,Swift Swim,Hydration,Water Absorb,50,50,40,50,40,64,294,0.5,0.5,,Water 1,,9.9,1.08,100,80,5
536,536,Palpitoad,0,Water,Ground,Swift Swim,Hydration,Water Absorb,75,65,55,65,55,69,384,0.5,0.5,Tympole,Water 1,,37.5,2.07,130,110,5
537,537,Seismitoad,0,Water,Ground,Swift Swim,Poison Touch,Water Absorb,105,95,75,85,75,74,509,0.5,0.5,Palpitoad,Water 1,,136.7,4.11,180,150,5
538,538,Throh,0,Fighting,,Guts,Inner Focus,Mold Breaker,120,100,85,30,85,45,465,1,0,,Human-Like,,122.4,4.03,130,170,5
539,539,Sawk,0,Fighting,,Sturdy,Inner Focus,Mold Breaker,75,125,75,30,75,85,465,1,0,,Human-Like,,112.4,4.07,155,150,5
540,540,Sewaddle,0,Bug,Grass,Swarm,Chlorophyll,Overcoat,45,53,70,40,60,42,310,0.5,0.5,,Bug,,5.5,1,93,130,5
541,541,Swadloon,0,Bug,Grass,Leaf Guard,Chlorophyll,Overcoat,55,63,90,50,80,42,380,0.5,0.5,Sewaddle,Bug,,16.1,1.08,113,170,5
542,542,Leavanny,0,Bug,Grass,Swarm,Chlorophyll,Overcoat,75,103,80,70,80,92,500,0.5,0.5,Swadloon,Bug,,45.2,3.11,173,160,5
543,543,Venipede,0,Bug,Poison,Poison Point,Swarm,Speed Boost,30,45,59,30,39,57,260,0.5,0.5,,Bug,,11.7,1.04,75,98,5
544,544,Whirlipede,0,Bug,Poison,Poison Point,Swarm,Speed Boost,40,55,99,40,79,47,360,0.5,0.5,Venipede,Bug,,129,3.11,95,178,5
545,545,Scolipede,0,Bug,Poison,Poison Point,Swarm,Speed Boost,60,100,89,55,69,112,485,0.5,0.5,Whirlipede,Bug,,442,8.02,155,158,5
546,546,Cottonee,0,Grass,Fairy,Prankster,Infiltrator,Chlorophyll,40,27,60,37,50,66,280,0.5,0.5,,Grass,Fairy,1.3,1,64,110,5
547,547,Whimsicott,0,Grass,Fairy,Prankster,Infiltrator,Chlorophyll,60,67,85,77,75,116,480,0.5,0.5,Cottonee,Grass,Fairy,14.6,2.04,144,160,5
548,548,Petilil,0,Grass,,Chlorophyll,Own Tempo,Leaf Guard,45,35,50,70,50,30,280,0,1,,Grass,,14.6,1.08,105,100,5
549,549,Lilligant,0,Grass,,Chlorophyll,Own Tempo,Leaf Guard,70,60,75,110,75,90,480,0,1,Petilil,Grass,,35.9,3.07,170,150,5
550,550,Basculin,0,Water,,Reckless,Adaptability,Mold Breaker,70,92,65,80,55,98,460,0.5,0.5,,Water 2,,39.7,3.03,172,120,5
551,551,Sandile,0,Ground,Dark,Intimidate,Moxie,Anger Point,50,72,35,35,35,65,292,0.5,0.5,,Field,,33.5,2.04,107,70,5
552,552,Krokorok,0,Ground,Dark,Intimidate,Moxie,Anger Point,60,82,45,45,45,74,351,0.5,0.5,Sandile,Field,,73.6,3.03,127,90,5
553,553,Krookodile,0,Ground,Dark,Intimidate,Moxie,Anger Point,95,117,80,65,70,92,519,0.5,0.5,Krokorok,Field,,212.3,4.11,182,150,5
554,554,Darumaka,0,Fire,,Hustle,,Inner Focus,70,90,45,15,45,50,315,0.5,0.5,,Field,,82.7,2,105,90,5
555,555,Darmanitan,0,Fire,,Sheer Force,,Zen Mode,105,140,55,30,55,95,480,0.5,0.5,Darumaka,Field,,204.8,4.03,170,110,5
556,556,Maractus,0,Grass,,Water Absorb,Chlorophyll,Storm Drain,75,86,67,106,67,60,461,0.5,0.5,,Grass,,61.7,3.03,192,134,5
557,557,Dwebble,0,Bug,Rock,Sturdy,Shell Armor,Weak Armor,50,65,85,35,35,55,325,0.5,0.5,,Bug,Mineral,32,1,100,120,5
558,558,Crustle,0,Bug,Rock,Sturdy,Shell Armor,Weak Armor,70,105,125,65,75,45,485,0.5,0.5,Dwebble,Bug,Mineral,440.9,4.07,170,200,5
559,559,Scraggy,0,Dark,Fighting,Shed Skin,Moxie,Intimidate,50,75,70,35,70,48,348,0.5,0.5,,Field,Dragon,26,2,110,140,5
560,560,Scrafty,0,Dark,Fighting,Shed Skin,Moxie,Intimidate,65,90,115,45,115,58,488,0.5,0.5,Scraggy,Field,Dragon,66.1,3.07,135,230,5
561,561,Sigilyph,0,Psychic,Flying,Wonder Skin,Magic Guard,Tinted Lens,72,58,80,103,80,97,490,0.5,0.5,,Flying,,30.9,4.07,161,160,5
562,562,Yamask,0,Ghost,,Mummy,,,38,30,85,55,65,30,303,0.5,0.5,,Mineral,Amorphous,3.3,1.08,85,150,5
563,563,Cofagrigus,0,Ghost,,Mummy,,,58,50,145,95,105,30,483,0.5,0.5,Yamask,Mineral,Amorphous,168.7,5.07,145,250,5
564,564,Tirtouga,0,Water,Rock,Solid Rock,Sturdy,Swift Swim,54,78,103,53,45,22,355,0.875,0.125,,Water 1,Water 3,36.4,2.04,131,148,5
565,565,Carracosta,0,Water,Rock,Solid Rock,Sturdy,Swift Swim,74,108,133,83,65,32,495,0.875,0.125,Tirtouga,Water 1,Water 3,178.6,3.11,191,198,5
566,566,Archen,0,Rock,Flying,Defeatist,,,55,112,45,74,45,70,401,0.875,0.125,,Flying,Water 3,20.9,1.08,186,90,5
567,567,Archeops,0,Rock,Flying,Defeatist,,,75,140,65,112,65,110,567,0.875,0.125,Archen,Flying,Water 3,70.5,4.07,252,130,5
568,568,Trubbish,0,Poison,,Stench,Sticky Hold,Aftermath,50,50,62,40,62,65,329,0.5,0.5,,Mineral,,68.3,2,90,124,5
569,569,Garbodor,0,Poison,,Stench,Weak Armor,Aftermath,80,95,82,60,82,75,474,0.5,0.5,Trubbish,Mineral,,236.6,6.03,155,164,5
570,570,Zorua,0,Dark,,Illusion,,,40,65,40,80,40,65,330,0.875,0.125,,Field,,27.6,2.04,145,80,5
571,571,Zoroark,0,Dark,,Illusion,,,60,105,60,120,60,105,510,0.875,0.125,Zorua,Field,,178.8,5.03,225,120,5
572,572,Minccino,0,Normal,,Cute Charm,Technician,Skill Link,55,50,40,40,40,75,300,0.5,0.5,,Field,,12.8,1.04,90,80,5
573,573,Cinccino,0,Normal,,Cute Charm,Technician,Skill Link,75,95,60,65,60,115,470,0.5,0.5,Minccino,Field,,16.5,1.08,160,120,5
574,574,Gothita,0,Psychic,,Frisk,Competitive,Shadow Tag,45,30,50,55,65,45,290,0.5,0.5,,Human-Like,,12.8,1.04,85,115,5
575,575,Gothorita,0,Psychic,,Frisk,Competitive,Shadow Tag,60,45,70,75,85,55,390,0.5,0.5,Gothita,Human-Like,,39.7,2.04,120,155,5
576,576,Gothitelle,0,Psychic,,Frisk,Competitive,Shadow Tag,70,55,95,95,110,65,490,0.5,0.5,Gothorita,Human-Like,,97,4.11,150,205,5
577,577,Solosis,0,Psychic,,Overcoat,Magic Guard,Regenerator,45,30,40,105,50,20,290,0.5,0.5,,Amorphous,,2.2,1,135,90,5
578,578,Duosion,0,Psychic,,Overcoat,Magic Guard,Regenerator,65,40,50,125,60,30,370,0.5,0.5,Solosis,Amorphous,,17.6,2,165,110,5
579,579,Reuniclus,0,Psychic,,Overcoat,Magic Guard,Regenerator,110,65,75,125,85,30,490,0.5,0.5,Duosion,Amorphous,,44.3,3.03,190,160,5
580,580,Ducklett,0,Water,Flying,Keen Eye,Big Pecks,Hydration,62,44,50,44,50,55,305,0.5,0.5,,Water 1,Flying,12.1,1.08,88,100,5
581,581,Swanna,0,Water,Flying,Keen Eye,Big Pecks,Hydration,75,87,63,87,63,98,473,0.5,0.5,Ducklett,Water 1,Flying,53.4,4.03,174,126,5
582,582,Vanillite,0,Ice,,Ice Body,Snow Cloak,Weak Armor,36,50,50,65,60,44,305,0.5,0.5,,Mineral,,12.6,1.04,115,110,5
583,583,Vanillish,0,Ice,,Ice Body,Snow Cloak,Weak Armor,51,65,65,80,75,59,395,0.5,0.5,Vanillite,Mineral,,90.4,3.07,145,140,5
584,584,Vanilluxe,0,Ice,,Ice Body,Snow Warning,Weak Armor,71,95,85,110,95,79,535,0.5,0.5,Vanillish,Mineral,,126.8,4.03,205,180,5
585,585,Deerling,0,Normal,Grass,Chlorophyll,Sap Sipper,Serene Grace,60,60,50,40,50,75,335,0.5,0.5,,Field,,43,2,100,100,5
586,586,Sawsbuck,0,Normal,Grass,Chlorophyll,Sap Sipper,Serene Grace,80,100,70,60,70,95,475,0.5,0.5,Deerling,Field,,203.9,6.03,160,140,5
587,587,Emolga,0,Electric,Flying,Static,,Motor Drive,55,75,60,75,60,103,428,0.5,0.5,,Field,,11,1.04,150,120,5
588,588,Karrablast,0,Bug,,Swarm,Shed Skin,No Guard,50,75,45,40,45,60,315,0.5,0.5,,Bug,,13,1.08,115,90,5
589,589,Escavalier,0,Bug,Steel,Swarm,Shell Armor,Overcoat,70,135,105,60,105,20,495,0.5,0.5,Karrablast,Bug,,72.8,3.03,195,210,5
590,590,Foongus,0,Grass,Poison,Effect Spore,,Regenerator,69,55,45,55,55,15,294,0.5,0.5,,Grass,,2.2,0.08,110,100,5
591,591,Amoonguss,0,Grass,Poison,Effect Spore,,Regenerator,114,85,70,85,80,30,464,0.5,0.5,Foongus,Grass,,23.1,2,170,150,5
592,592,Frillish,0,Water,Ghost,Water Absorb,Cursed Body,Damp,55,40,50,65,85,40,335,0.5,0.5,,Amorphous,,72.8,3.11,105,135,5
593,593,Jellicent,0,Water,Ghost,Water Absorb,Cursed Body,Damp,100,60,70,85,105,60,480,0.5,0.5,Frillish,Amorphous,,297.6,7.03,145,175,5
594,594,Alomomola,0,Water,,Healer,Hydration,Regenerator,165,75,80,40,45,65,470,0.5,0.5,,Water 1,Water 2,69.7,3.11,115,125,5
595,595,Joltik,0,Bug,Electric,Compound Eyes,Unnerve,Swarm,50,47,50,57,50,65,319,0.5,0.5,,Bug,,1.3,0.04,104,100,5
596,596,Galvantula,0,Bug,Electric,Compound Eyes,Unnerve,Swarm,70,77,60,97,60,108,472,0.5,0.5,Joltik,Bug,,31.5,2.07,174,120,5
597,597,Ferroseed,0,Grass,Steel,Iron Barbs,,,44,50,91,24,86,10,305,0.5,0.5,,Grass,Mineral,41.4,2,74,177,5
598,598,Ferrothorn,0,Grass,Steel,Iron Barbs,,Anticipation,74,94,131,54,116,20,489,0.5,0.5,Ferroseed,Grass,Mineral,242.5,3.03,148,247,5
599,599,Klink,0,Steel,,Plus,Minus,Clear Body,40,55,70,45,60,30,300,0.5,0.5,,Mineral,,46.3,1,100,130,5
600,600,Klang,0,Steel,,Plus,Minus,Clear Body,60,80,95,70,85,50,440,0.5,0.5,Klink,Mineral,,112.4,2,150,180,5
601,601,Klinklang,0,Steel,,Plus,Minus,Clear Body,60,100,115,70,85,90,520,0.5,0.5,Klang,Mineral,,178.6,2,170,200,5
602,602,Tynamo,0,Electric,,Levitate,,,35,55,40,45,40,60,275,0.5,0.5,,Amorphous,,0.7,0.08,100,80,5
603,603,Eelektrik,0,Electric,,Levitate,,,65,85,70,75,70,40,405,0.5,0.5,Tynamo,Amorphous,,48.5,3.11,160,140,5
604,604,Eelektross,0,Electric,,Levitate,,,85,115,80,105,80,50,515,0.5,0.5,Eelektrik,Amorphous,,177.5,6.11,220,160,5
605,605,Elgyem,0,Psychic,,Telepathy,Synchronize,Analytic,55,55,55,85,55,30,335,0.5,0.5,,Human-Like,,19.8,1.08,140,110,5
606,606,Beheeyem,0,Psychic,,Telepathy,Synchronize,Analytic,75,75,75,125,95,40,485,0.5,0.5,Elgyem,Human-Like,,76.1,3.03,200,170,5
607,607,Litwick,0,Ghost,Fire,Flash Fire,Flame Body,Infiltrator,50,30,55,65,55,20,275,0.5,0.5,,Amorphous,,6.8,1,95,110,5
608,608,Lampent,0,Ghost,Fire,Flash Fire,Flame Body,Infiltrator,60,40,60,95,60,55,370,0.5,0.5,Litwick,Amorphous,,28.7,2,135,120,5
609,609,Chandelure,0,Ghost,Fire,Flash Fire,Flame Body,Infiltrator,60,55,90,145,90,80,520,0.5,0.5,Lampent,Amorphous,,75.6,3.03,200,180,5
610,610,Axew,0,Dragon,,Rivalry,Mold Breaker,Unnerve,46,87,60,30,40,57,320,0.5,0.5,,Monster,Dragon,39.7,2,117,100,5
611,611,Fraxure,0,Dragon,,Rivalry,Mold Breaker,Unnerve,66,117,70,40,50,67,410,0.5,0.5,Axew,Monster,Dragon,79.4,3.03,157,120,5
612,612,Haxorus,0,Dragon,,Rivalry,Mold Breaker,Unnerve,76,147,90,60,70,97,540,0.5,0.5,Fraxure,Monster,Dragon,232.6,5.11,207,160,5
613,613,Cubchoo,0,Ice,,Snow Cloak,Slush Rush,Rattled,55,70,40,60,40,40,305,0.5,0.5,,Field,,18.7,1.08,130,80,5
614,614,Beartic,0,Ice,,Snow Cloak,Slush Rush,Swift Swim,95,130,80,70,80,50,505,0.5,0.5,Cubchoo,Field,,573.2,8.06,200,160,5
615,615,Cryogonal,0,Ice,,Levitate,,,80,50,50,95,135,105,515,NA,NA,,Mineral,,326.3,3.07,145,185,5
616,616,Shelmet,0,Bug,,Hydration,Shell Armor,Overcoat,50,40,85,40,65,25,305,0.5,0.5,,Bug,,17,1.04,80,150,5
617,617,Accelgor,0,Bug,,Hydration,Sticky Hold,Unburden,80,70,40,100,60,145,495,0.5,0.5,Shelmet,Bug,,55.8,2.07,170,100,5
618,618,Stunfisk,0,Ground,Electric,Static,Limber,Sand Veil,109,66,84,81,99,32,471,0.5,0.5,,Water 1,Amorphous,24.3,2.04,147,183,5
619,619,Mienfoo,0,Fighting,,Inner Focus,Regenerator,Reckless,45,85,50,55,50,65,350,0.5,0.5,,Field,Human-Like,44.1,2.11,140,100,5
620,620,Mienshao,0,Fighting,,Inner Focus,Regenerator,Reckless,65,125,60,95,60,105,510,0.5,0.5,Mienfoo,Field,Human-Like,78.3,4.07,220,120,5
621,621,Druddigon,0,Dragon,,Rough Skin,Sheer Force,Mold Breaker,77,120,90,60,90,48,485,0.5,0.5,,Dragon,Monster,306.4,5.03,180,180,5
622,622,Golett,0,Ground,Ghost,Iron Fist,Klutz,No Guard,59,74,50,35,50,35,303,NA,NA,,Mineral,,202.8,3.03,109,100,5
623,623,Golurk,0,Ground,Ghost,Iron Fist,Klutz,No Guard,89,124,80,55,80,55,483,NA,NA,Golett,Mineral,,727.5,9.02,179,160,5
624,624,Pawniard,0,Dark,Steel,Defiant,Inner Focus,Pressure,45,85,70,40,40,60,340,0.5,0.5,,Human-Like,,22.5,1.08,125,110,5
625,625,Bisharp,0,Dark,Steel,Defiant,Inner Focus,Pressure,65,125,100,60,70,70,490,0.5,0.5,Pawniard,Human-Like,,154.3,5.03,185,170,5
626,626,Bouffalant,0,Normal,,Reckless,Sap Sipper,Soundproof,95,110,95,40,95,55,490,0.5,0.5,,Field,,208.6,5.03,150,190,5
627,627,Rufflet,0,Normal,Flying,Keen Eye,Sheer Force,Hustle,70,83,50,37,50,60,350,1,0,,Flying,,23.1,1.08,120,100,5
628,628,Braviary,0,Normal,Flying,Keen Eye,Sheer Force,Defiant,100,123,75,57,75,80,510,1,0,Rufflet,Flying,,90.4,4.11,180,150,5
629,629,Vullaby,0,Dark,Flying,Big Pecks,Overcoat,Weak Armor,70,55,75,45,65,60,370,0,1,,Flying,,19.8,1.08,100,140,5
630,630,Mandibuzz,0,Dark,Flying,Big Pecks,Overcoat,Weak Armor,110,65,105,55,95,80,510,0,1,Vullaby,Flying,,87.1,3.11,120,200,5
631,631,Heatmor,0,Fire,,Gluttony,Flash Fire,White Smoke,85,97,66,105,66,65,484,0.5,0.5,,Field,,127.9,4.07,202,132,5
632,632,Durant,0,Bug,Steel,Swarm,Hustle,Truant,58,109,112,48,48,109,484,0.5,0.5,,Bug,,72.8,1,157,160,5
633,633,Deino,0,Dark,Dragon,Hustle,,,52,65,50,45,50,38,300,0.5,0.5,,Dragon,,38.1,2.07,110,100,5
634,634,Zweilous,0,Dark,Dragon,Hustle,,,72,85,70,65,70,58,420,0.5,0.5,Deino,Dragon,,110.2,4.07,150,140,5
635,635,Hydreigon,0,Dark,Dragon,Levitate,,,92,105,90,125,90,98,600,0.5,0.5,Zweilous,Dragon,,352.7,5.11,230,180,5
636,636,Larvesta,0,Bug,Fire,Flame Body,,Swarm,55,85,55,50,55,60,360,0.5,0.5,,Bug,,63.5,3.07,135,110,5
637,637,Volcarona,0,Bug,Fire,Flame Body,,Swarm,85,60,65,135,105,100,550,0.5,0.5,Larvesta,Bug,,101.4,5.03,195,170,5
638,638,Cobalion,0,Steel,Fighting,Justified,,,91,90,129,90,72,108,580,NA,NA,,Undiscovered,,551.2,6.11,180,201,5
639,639,Terrakion,0,Rock,Fighting,Justified,,,91,129,90,72,90,108,580,NA,NA,,Undiscovered,,573.2,6.03,201,180,5
640,640,Virizion,0,Grass,Fighting,Justified,,,91,90,72,90,129,108,580,NA,NA,,Undiscovered,,440.9,6.07,180,201,5
641,641,Tornadus,0,Flying,,Prankster,,Defiant,79,115,70,125,80,111,580,1,0,,Undiscovered,,138.9,4.11,240,150,5
642,642,Thundurus,0,Electric,Flying,Prankster,,Defiant,79,115,70,125,80,111,580,1,0,,Undiscovered,,134.5,4.11,240,150,5
643,643,Reshiram,0,Dragon,Fire,Turboblaze,,,100,120,100,150,120,90,680,NA,NA,,Undiscovered,,727.5,10.06,270,220,5
644,644,Zekrom,0,Dragon,Electric,Teravolt,,,100,150,120,120,100,90,680,NA,NA,,Undiscovered,,760.6,9.06,270,220,5
645,645,Landorus,0,Ground,Flying,Sand Force,,Sheer Force,89,125,90,115,80,101,600,1,0,,Undiscovered,,149.9,4.11,240,170,5
646,646,Kyurem,0,Dragon,Ice,Pressure,,,125,130,90,130,90,95,660,NA,NA,,Undiscovered,,716.5,9.1,260,180,5
647,647,Keldeo,0,Water,Fighting,Justified,,,91,72,90,129,90,108,580,NA,NA,,Undiscovered,,106.9,4.07,201,180,5
648,648,Meloetta,0,Normal,Psychic,Serene Grace,,,100,77,77,128,128,90,600,NA,NA,,Undiscovered,,14.3,2,205,205,5
649,649,Genesect,0,Bug,Steel,Download,,,71,120,95,120,95,99,600,NA,NA,,Undiscovered,,181.9,4.11,240,190,5
650,650,Chespin,0,Grass,,Overgrow,,Bulletproof,56,61,65,48,45,38,313,0.875,0.125,,Field,,19.8,1.04,109,110,6
651,651,Quilladin,0,Grass,,Overgrow,,Bulletproof,61,78,95,56,58,57,405,0.875,0.125,Chespin,Field,,63.9,2.04,134,153,6
652,652,Chesnaught,0,Grass,Fighting,Overgrow,,Bulletproof,88,107,122,74,75,64,530,0.875,0.125,Quilladin,Field,,198.4,5.03,181,197,6
653,653,Fennekin,0,Fire,,Blaze,,Magician,40,45,40,62,60,60,307,0.875,0.125,,Field,,20.7,1.04,107,100,6
654,654,Braixen,0,Fire,,Blaze,,Magician,59,59,58,90,70,73,409,0.875,0.125,Fennekin,Field,,32,3.03,149,128,6
655,655,Delphox,0,Fire,Psychic,Blaze,,Magician,75,69,72,114,100,104,534,0.875,0.125,Braixen,Field,,86,4.11,183,172,6
656,656,Froakie,0,Water,,Torrent,,Protean,41,56,40,62,44,71,314,0.875,0.125,,Water 1,,15.4,1,118,84,6
657,657,Frogadier,0,Water,,Torrent,,Protean,54,63,52,83,56,97,405,0.875,0.125,Froakie,Water 1,,24,2,146,108,6
658,658,Greninja,0,Water,Dark,Torrent,Torrent,Protean,72,95,67,103,71,122,530,0.875,0.125,Frogadier,Water 1,,88.2,4.11,198,138,6
659,659,Bunnelby,0,Normal,,Pickup,Cheek Pouch,Huge Power,38,36,38,32,36,57,237,0.5,0.5,,Field,,11,1.04,68,74,6
660,660,Diggersby,0,Normal,Ground,Pickup,Cheek Pouch,Huge Power,85,56,77,50,77,78,423,0.5,0.5,Bunnelby,Field,,93.5,3.03,106,154,6
661,661,Fletchling,0,Normal,Flying,Big Pecks,,Gale Wings,45,50,43,40,38,62,278,0.5,0.5,,Flying,,3.7,1,90,81,6
662,662,Fletchinder,0,Fire,Flying,Flame Body,,Gale Wings,62,73,55,56,52,84,382,0.5,0.5,Fletchling,Flying,,35.3,2.04,129,107,6
663,663,Talonflame,0,Fire,Flying,Flame Body,,Gale Wings,78,81,71,74,69,126,499,0.5,0.5,Fletchinder,Flying,,54,3.11,155,140,6
664,664,Scatterbug,0,Bug,,Shield Dust,Compound Eyes,Friend Guard,38,35,40,27,25,35,200,0.5,0.5,,Bug,,5.5,1,62,65,6
665,665,Spewpa,0,Bug,,Shed Skin,,Friend Guard,45,22,60,27,30,29,213,0.5,0.5,Scatterbug,Bug,,18.5,1,49,90,6
666,666,Vivillon,0,Bug,Flying,Shield Dust,Compound Eyes,Friend Guard,80,52,50,90,50,89,411,0.5,0.5,Spewpa,Bug,,37.5,3.11,142,100,6
667,667,Litleo,0,Fire,Normal,Rivalry,Unnerve,Moxie,62,50,58,73,54,72,369,0.75,0.25,,Field,,29.8,2,123,112,6
668,668,Pyroar,0,Fire,Normal,Rivalry,Unnerve,Moxie,86,68,72,109,66,106,507,0.75,0.25,Litleo,Field,,179.7,4.11,177,138,6
669,669,Flabébé,0,Fairy,,Flower Veil,,Symbiosis,44,38,39,61,79,42,303,0,1,,Fairy,,0.2,0.04,99,118,6
670,670,Floette,0,Fairy,,Flower Veil,,Symbiosis,54,45,47,75,98,52,371,0,1,Flabébé,Fairy,,2,0.08,120,145,6
671,671,Florges,0,Fairy,,Flower Veil,,Symbiosis,78,65,68,112,154,75,552,0,1,Floette,Fairy,,22,3.07,177,222,6
672,672,Skiddo,0,Grass,,Sap Sipper,,Grass Pelt,66,65,48,62,57,52,350,0.5,0.5,,Field,,68.3,2.11,127,105,6
673,673,Gogoat,0,Grass,,Sap Sipper,,Grass Pelt,123,100,62,97,81,68,531,0.5,0.5,Skiddo,Field,,200.6,5.07,197,143,6
674,674,Pancham,0,Dark,,Iron Fist,Mold Breaker,Scrappy,67,82,62,46,48,43,348,0.5,0.5,,Field,Human-Like,17.6,2,128,110,6
675,675,Pangoro,0,Dark,Fighting,Iron Fist,Mold Breaker,Scrappy,95,124,78,69,71,58,495,0.5,0.5,Pancham,Field,Human-Like,299.8,6.11,193,149,6
676,676,Furfrou,0,Normal,,Fur Coat,,,75,80,60,65,90,102,472,0.5,0.5,,Field,,61.7,3.11,145,150,6
677,677,Espurr,0,Psychic,,Keen Eye,Infiltrator,Own Tempo,62,48,54,63,60,68,355,0.5,0.5,,Field,,7.7,1,111,114,6
678,678,Meowstic,0,Psychic,,Keen Eye,Infiltrator,Prankster,74,48,76,83,81,104,466,1,0,Espurr,Field,,18.7,2,131,157,6
679,679,Honedge,0,Steel,Ghost,No Guard,,,45,80,100,35,37,28,325,0.5,0.5,,Mineral,,4.4,2.07,115,137,6
680,680,Doublade,0,Steel,Ghost,No Guard,,,59,110,150,45,49,35,448,0.5,0.5,Honedge,Mineral,,9.9,2.07,155,199,6
681,681,Aegislash,0,Steel,Ghost,Stance Change,,,60,50,150,50,150,60,520,0.5,0.5,Doublade,Mineral,,116.8,5.07,100,300,6
682,682,Spritzee,0,Fairy,,Healer,,Aroma Veil,78,52,60,63,65,23,341,0.5,0.5,,Fairy,,1.1,0.08,115,125,6
683,683,Aromatisse,0,Fairy,,Healer,,Aroma Veil,101,72,72,99,89,29,462,0.5,0.5,Spritzee,Fairy,,34.2,2.07,171,161,6
684,684,Swirlix,0,Fairy,,Sweet Veil,,Unburden,62,48,66,59,57,49,341,0.5,0.5,,Fairy,,7.7,1.04,107,123,6
685,685,Slurpuff,0,Fairy,,Sweet Veil,,Unburden,82,80,86,85,75,72,480,0.5,0.5,Swirlix,Fairy,,11,2.07,165,161,6
686,686,Inkay,0,Dark,Psychic,Contrary,Suction Cups,Infiltrator,53,54,53,37,46,45,288,0.5,0.5,,Water 1,Water 2,7.7,1.04,91,99,6
687,687,Malamar,0,Dark,Psychic,Contrary,Suction Cups,Infiltrator,86,92,88,68,75,73,482,0.5,0.5,Inkay,Water 1,Water 2,103.6,4.11,160,163,6
688,688,Binacle,0,Rock,Water,Tough Claws,Sniper,Pickpocket,42,52,67,39,56,50,306,0.5,0.5,,Water 3,,68.3,1.08,91,123,6
689,689,Barbaracle,0,Rock,Water,Tough Claws,Sniper,Pickpocket,72,105,115,54,86,68,500,0.5,0.5,Binacle,Water 3,,211.6,4.03,159,201,6
690,690,Skrelp,0,Poison,Water,Poison Point,Poison Touch,Adaptability,50,60,60,60,60,30,320,0.5,0.5,,Water 1,Dragon,16.1,1.08,120,120,6
691,691,Dragalge,0,Poison,Dragon,Poison Point,Poison Touch,Adaptability,65,75,90,97,123,44,494,0.5,0.5,Skrelp,Water 1,Dragon,179.7,5.11,172,213,6
692,692,Clauncher,0,Water,,Mega Launcher,,,50,53,62,58,63,44,330,0.5,0.5,,Water 1,Water 3,18.3,1.08,111,125,6
693,693,Clawitzer,0,Water,,Mega Launcher,,,71,73,88,120,89,59,500,0.5,0.5,Clauncher,Water 1,Water 3,77.8,4.03,193,177,6
694,694,Helioptile,0,Electric,Normal,Dry Skin,Sand Veil,Solar Power,44,38,33,61,43,70,289,0.5,0.5,,Monster,Dragon,13.2,1.08,99,76,6
695,695,Heliolisk,0,Electric,Normal,Dry Skin,Sand Veil,Solar Power,62,55,52,109,94,109,481,0.5,0.5,Helioptile,Monster,Dragon,46.3,3.03,164,146,6
696,696,Tyrunt,0,Rock,Dragon,Strong Jaw,,Sturdy,58,89,77,45,45,48,362,0.875,0.125,,Monster,Dragon,57.3,2.07,134,122,6
697,697,Tyrantrum,0,Rock,Dragon,Strong Jaw,,Rock Head,82,121,119,69,59,71,521,0.875,0.125,Tyrunt,Monster,Dragon,595.2,8.02,190,178,6
698,698,Amaura,0,Rock,Ice,Refrigerate,,Snow Warning,77,59,50,67,63,46,362,0.875,0.125,,Monster,,55.6,4.03,126,113,6
699,699,Aurorus,0,Rock,Ice,Refrigerate,,Snow Warning,123,77,72,99,92,58,521,0.875,0.125,Amaura,Monster,,496,8.1,176,164,6
700,700,Sylveon,0,Fairy,,Cute Charm,,Pixilate,95,65,65,110,130,60,525,0.875,0.125,Eevee,Field,,51.8,3.03,175,195,6
701,701,Hawlucha,0,Fighting,Flying,Limber,Unburden,Mold Breaker,78,92,75,74,63,118,500,0.5,0.5,,Human-Like,,47.4,2.07,166,138,6
702,702,Dedenne,0,Electric,Fairy,Cheek Pouch,Pickup,Plus,67,58,57,81,67,101,431,0.5,0.5,,Field,Fairy,4.9,0.08,139,124,6
703,703,Carbink,0,Rock,Fairy,Clear Body,,Sturdy,50,50,150,50,150,50,500,NA,NA,,Fairy,Mineral,12.6,1,100,300,6
704,704,Goomy,0,Dragon,,Sap Sipper,Hydration,Gooey,45,50,35,55,75,40,300,0.5,0.5,,Dragon,,6.2,1,105,110,6
705,705,Sliggoo,0,Dragon,,Sap Sipper,Hydration,Gooey,68,75,53,83,113,60,452,0.5,0.5,Goomy,Dragon,,38.6,2.07,158,166,6
706,706,Goodra,0,Dragon,,Sap Sipper,Hydration,Gooey,90,100,70,110,150,80,600,0.5,0.5,Sliggoo,Dragon,,331.8,6.07,210,220,6
707,707,Klefki,0,Steel,Fairy,Prankster,,Magician,57,80,91,80,87,75,470,0.5,0.5,,Mineral,,6.6,0.08,160,178,6
708,708,Phantump,0,Ghost,Grass,Natural Cure,Frisk,Harvest,43,70,48,50,60,38,309,0.5,0.5,,Grass,Amorphous,15.4,1.04,120,108,6
709,709,Trevenant,0,Ghost,Grass,Natural Cure,Frisk,Harvest,85,110,76,65,82,56,474,0.5,0.5,Phantump,Grass,Amorphous,156.5,4.11,175,158,6
710,710,Pumpkaboo,0,Ghost,Grass,Pickup,Frisk,Insomnia,49,66,70,44,55,51,335,0.5,0.5,,Amorphous,,11,1.04,110,125,6
711,711,Gourgeist,0,Ghost,Grass,Pickup,Frisk,Insomnia,65,90,122,58,75,84,494,0.5,0.5,Pumpkaboo (Average Size),Amorphous,,27.6,2.11,148,197,6
712,712,Bergmite,0,Ice,,Own Tempo,Ice Body,Sturdy,55,69,85,32,35,28,304,0.5,0.5,,Monster,,219.4,3.03,101,120,6
713,713,Avalugg,0,Ice,,Own Tempo,Ice Body,Sturdy,95,117,184,44,46,28,514,0.5,0.5,Bergmite,Monster,,1113.3,6.07,161,230,6
714,714,Noibat,0,Flying,Dragon,Frisk,Infiltrator,Telepathy,40,30,35,45,40,55,245,0.5,0.5,,Flying,,17.6,1.08,75,75,6
715,715,Noivern,0,Flying,Dragon,Frisk,Infiltrator,Telepathy,85,70,80,97,80,123,535,0.5,0.5,Noibat,Flying,,187.4,4.11,167,160,6
716,716,Xerneas,0,Fairy,,Fairy Aura,,,126,131,95,131,98,99,680,NA,NA,,Undiscovered,,474,9.1,262,193,6
717,717,Yveltal,0,Dark,Flying,Dark Aura,,,126,131,95,131,98,99,680,NA,NA,,Undiscovered,,447.5,19,262,193,6
718,718,Zygarde,0,Dragon,Ground,Aura Break,,,108,100,121,81,95,95,600,NA,NA,,Undiscovered,,672.4,16.05,181,216,6
719,719,Diancie,0,Rock,Fairy,Clear Body,,,50,100,150,100,150,50,600,NA,NA,,Undiscovered,,19.4,2.04,200,300,6
720,720,Hoopa,0,Psychic,Ghost,Magician,,,80,110,60,150,130,70,600,NA,NA,,Undiscovered,,19.8,1.08,260,190,6
721,721,Volcanion,0,Fire,Water,Water Absorb,,,80,110,120,130,90,70,600,NA,NA,,Undiscovered,,429.9,5.07,240,210,6
722,722,Rowlet,0,Grass,Flying,Overgrow,Overgrow,Long Reach,68,55,55,50,50,42,320,0.875,0.125,,Flying,,3.3,1,105,105,7
723,723,Dartrix,0,Grass,Flying,Overgrow,Overgrow,Long Reach,78,75,75,70,70,52,420,0.875,0.125,Rowlet,Flying,,35.3,2.04,145,145,7
724,724,Decidueye,0,Grass,Ghost,Overgrow,Overgrow,Long Reach,78,107,75,100,100,70,530,0.875,0.125,Dartrix,Flying,,80.7,5.03,207,175,7
725,725,Litten,0,Fire,,Blaze,Blaze,Intimidate,45,65,40,60,40,70,320,0.875,0.125,,Field,,9.5,1.04,125,80,7
726,726,Torracat,0,Fire,,Blaze,Blaze,Intimidate,65,85,50,80,50,90,420,0.875,0.125,Litten,Field,,55.1,2.04,165,100,7
727,727,Incineroar,0,Fire,Dark,Blaze,Blaze,Intimidate,95,115,90,80,90,60,530,0.875,0.125,Torracat,Field,,183,5.11,195,180,7
728,728,Popplio,0,Water,,Torrent,Torrent,Liquid Voice,50,54,54,66,56,40,320,0.875,0.125,,Water 1,Field,16.5,1.04,120,110,7
729,729,Brionne,0,Water,,Torrent,Torrent,Liquid Voice,60,69,69,91,81,50,420,0.875,0.125,Popplio,Water 1,Field,38.6,2,160,150,7
730,730,Primarina,0,Water,Fairy,Torrent,Torrent,Liquid Voice,80,74,74,126,116,60,530,0.875,0.125,Brionne,Water 2,Field,97,5.11,200,190,7
731,731,Pikipek,0,Normal,Flying,Keen Eye,Skill Link,Pickup,35,75,30,30,30,65,265,0.5,0.5,,Flying,,2.6,1,105,60,7
732,732,Trumbeak,0,Normal,Flying,Keen Eye,Skill Link,Pickup,55,85,50,40,50,75,355,0.5,0.5,Pipipek,Flying,,32.6,2,125,100,7
733,733,Toucannon,0,Normal,Flying,Keen Eye,Skill Link,Sheer Force,80,120,75,75,75,60,485,0.5,0.5,Trumbeak,Flying,,57.3,3.07,195,150,7
734,734,Yungoos,0,Normal,,Stakeout,Strong Jaw,Adaptability,48,70,30,30,30,45,253,0.5,0.5,,Field,,13.2,1.04,100,60,7
735,735,Gumshoos,0,Normal,,Stakeout,Strong Jaw,Adaptability,88,110,60,55,60,45,418,0.5,0.5,Yungoos,Field,,31.3,2.04,165,120,7
736,736,Grubbin,0,Bug,,Swarm,Swarm,Swarm,47,62,45,55,45,46,300,0.5,0.5,,Bug,,9.7,1.04,117,90,7
737,737,Charjabug,0,Bug,Electric,Battery,Battery,Battery,57,82,95,55,75,36,400,0.5,0.5,Grubbin,Bug,,23.1,1.08,137,170,7
738,738,Vikavolt,0,Bug,Electric,Levitate,Levitate,Levitate,77,70,90,145,75,43,500,0.5,0.5,Charjabug,Bug,,99.2,4.11,215,165,7
739,739,Crabrawler,0,Fighting,,Hyper Cutter,Iron Fist,Anger Point,47,82,57,42,47,63,338,0.5,0.5,,Water 3,,15.4,2,124,104,7
740,740,Crabominable,0,Fighting,Ice,Hyper Cutter,Iron Fist,Anger Point,97,132,77,62,67,43,478,0.5,0.5,Crabrawler,Water 4,,396.8,5.07,194,144,7
741,741,Oricorio,0,Fire,Flying,Dancer,Dancer,Dancer,75,70,70,98,70,93,476,0.25,0.75,,Flying,,7.5,2,168,140,7
742,742,Cutiefly,0,Bug,Fairy,Honey Gather,Shield Dust,Sweet Veil,40,45,40,55,40,84,304,0.5,0.5,,Bug,Fairy,0.4,0.04,100,80,7
743,743,Ribombee,0,Bug,Fairy,Honey Gather,Shield Dust,Sweet Veil,60,55,60,95,70,124,464,0.5,0.5,Cutiefly,Bug,Fairy,1.1,0.08,150,130,7
744,744,Rockruff,0,Rock,,Keen Eye,Vital spirit,Steadfast,45,65,40,30,40,60,280,0.5,0.5,,Field,,20.3,1.08,95,80,7
745,745,Lycanroc,0,Rock,,Keen Eye,Sand Rush,Steadfast,75,115,65,55,65,112,487,0.5,0.5,Rockruff,Field,,55.1,2.07,170,130,7
746,746,Wishiwashi,0,Water,,Schooling,Schooling,Schooling,45,20,20,25,25,40,175,0.5,0.5,,Water 2,,0.7,0.08,45,45,7
747,747,Mareanie,0,Poison,Water,Merciless,Limber,Regenerator,50,53,62,43,52,45,305,0.5,0.5,,Water 1,,17.6,1.04,96,114,7
748,748,Toxapex,0,Poison,Water,Merciless,Limber,Regenerator,50,63,152,53,142,35,495,0.5,0.5,Mareanie,Water 2,,32,2.04,116,294,7
749,749,Mudbray,0,Ground,,Own Tempo,Stamina,Inner Focus,70,100,70,45,55,45,385,0.5,0.5,,Field,,242.5,3.03,145,125,7
750,750,Mudsdale,0,Ground,,Own Tempo,Stamina,Inner Focus,100,125,100,55,85,35,500,0.5,0.5,Mudbray,Field,,2028.3,8.02,180,185,7
751,751,Dewpider,0,Water,Bug,Water Bubble,Water Bubble,Water Absorb,38,40,52,40,72,27,269,0.5,0.5,,Water 1,Bug,8.8,1,80,124,7
752,752,Araquanid,0,Water,Bug,Water Bubble,Water Bubble,Water Absorb,68,70,92,50,132,42,454,0.5,0.5,Dewpider,Water 2,Bug,180.8,5.11,120,224,7
753,753,Fomantis,0,Grass,,Leaf Guard,Leaf Guard,Contrary,40,55,35,50,35,35,250,0.5,0.5,,Grass,,3.3,1,105,70,7
754,754,Lurantis,0,Grass,,Leaf Guard,Leaf Guard,Contrary,70,105,90,80,90,45,480,0.5,0.5,Fomantis,Grass,,40.8,2.11,185,180,7
755,755,Morelull,0,Grass,Fairy,Illuminate,Effect Spore,Rain Dish,40,35,55,65,75,15,285,0.5,0.5,,Grass,,3.3,0.08,100,130,7
756,756,Shiinotic,0,Grass,Fairy,Illuminate,Effect Spore,Rain Dish,60,45,80,90,100,30,405,0.5,0.5,Morelull,Grass,,25.4,3.03,135,180,7
757,757,Salandit,0,Poison,Fire,Corrosion,Corrosion,Oblivious,48,44,40,71,40,77,320,0.875,0.125,,Monster,Dragon,10.6,2,115,80,7
758,758,Salazzle,0,Poison,Fire,Corrosion,Corrosion,Oblivious,68,64,60,111,60,117,480,0,1,Sandalit,Monster,Dragon,48.9,3.11,175,120,7
759,759,Stufful,0,Normal,Fighting,Fluffy,Klutz,Cute Charm,70,75,50,45,50,50,340,0.5,0.5,,Field,,15,1.08,120,100,7
760,760,Bewear,0,Normal,Fighting,Fluffy,Klutz,Unnerve,120,125,80,55,60,60,500,0.5,0.5,Stufful,Field,,297.6,6.11,180,140,7
761,761,Bounsweet,0,Grass,,Leaf Guard,Oblivious,Sweet Veil,42,30,38,30,38,32,210,0,1,,Grass,,7.1,1,60,76,7
762,762,Steenee,0,Grass,,Leaf Guard,Oblivious,Sweet Veil,52,40,48,40,48,62,290,0,1,Bounsweet,Grass,,18.1,2.04,80,96,7
763,763,Tsareena,0,Grass,,Leaf Guard,Queenly Majesty,Sweet Veil,72,120,98,50,98,72,510,0,1,Steenee,Grass,,47.2,3.11,170,196,7
764,764,Comfey,0,Fairy,,Flower Veil,Triage,Natural Cure,51,52,90,82,110,100,485,0.25,0.75,,Grass,,0.7,0.04,134,200,7
765,765,Oranguru,0,Normal,Psychic,Inner Focus,Telepahty,Symbiosis,90,60,80,90,110,60,490,0.5,0.5,,Field,,167.6,4.11,150,190,7
766,766,Passimian,0,Fighting,,Receiver,Receiver,Defiant,100,120,90,40,60,80,490,0.5,0.5,,Field,,182.5,6.07,160,150,7
767,767,Wimpod,0,Bug,Water,Wimp Out,Wimp Out,Wimp Out,25,35,40,20,30,80,230,0.5,0.5,,Bug,Water 3,26.5,1.08,55,70,7
768,768,Golisopod,0,Bug,Water,Emergency Exit,Emergency Exit,Emergency Exit,75,125,140,60,90,40,530,0.5,0.5,Wimpod,Bug,Water 3,238.1,6.07,185,230,7
769,769,Sandygast,0,Ghost,Ground,Water Compaction,Water Compaction,Sand Veil,55,55,80,70,45,15,320,0.5,0.5,,Amorphous,,154.3,1.08,125,125,7
770,770,Palossand,0,Ghost,Ground,Water Compaction,Water Compaction,Sand Veil,85,75,110,100,75,35,480,0.5,0.5,Sandygast,Amorphous,,551.2,4.03,175,185,7
771,771,Pyukumuku,0,Water,,Innards Out,Innards Out,Unaware,55,60,130,30,130,5,410,0.5,0.5,,Water 1,,2.6,1,90,260,7
772,772,Type: Null,0,Normal,,Battle Armor,Battle Armor,Battle Armor,95,95,95,95,95,59,534,NA,NA,,Undiscovered,,265.7,6.03,190,190,7
773,773,Silvally,0,Normal,,RKS System,RKS System,RKS System,95,95,95,95,95,95,570,NA,NA,Type: Null,Undiscovered,,221.6,7.07,190,190,7
774,774,Minior,0,Rock,Flying,Shields Down,Shields Down,Shields Down,60,60,100,60,100,60,440,NA,NA,,Mineral,,88.2,1,120,200,7
775,775,Komala,0,Normal,,Comatose,Comatose,Comatose,65,115,65,75,95,65,480,0.5,0.5,,Field,,43.9,1.04,190,160,7
776,776,Turtonator,0,Fire,Dragon,Shell Armor,Shell Armor,Shell Armor,60,78,135,91,85,36,485,0.5,0.5,,Monster,Dragon,467.4,6.07,169,220,7
777,777,Togedemaru,0,Electric,Steel,Iron Barbs,Lightning Rod,Sturdy,65,98,63,40,73,96,435,0.5,0.5,,Field,Fairy,7.3,1,138,136,7
778,778,Mimikyu,0,Ghost,Fairy,Disguise,Disguise,Disguise,55,90,80,50,105,96,476,0.5,0.5,,Amorphous,,1.5,0.08,140,185,7
779,779,Bruxish,0,Water,Psychic,Dazzling,Strong Jaw,Wonder Skin,68,105,70,70,70,92,475,0.5,0.5,,Water 2,,41.9,2.11,175,140,7
780,780,Drampa,0,Normal,Dragon,Berserk,Sap Sipper,Cloud Nine,78,60,85,135,91,36,485,0.5,0.5,,Monster,Dragon,407.9,9.1,195,176,7
781,781,Dhelmise,0,Ghost,Grass,Steelworker,Steelworker,Steelworker,70,131,100,86,90,40,517,NA,NA,,Mineral,,463,12.1,217,190,7
782,782,Jangmo-o,0,Dragon,,Bulletproof,Soundproof,Overcoat,45,55,65,45,45,45,300,0.5,0.5,,Dragon,,65.5,2,100,110,7
783,783,Hakamo-o,0,Dragon,Fighting,Bulletproof,Soundproof,Overcoat,55,75,90,65,70,65,420,0.5,0.5,Jangmo-o,Dragon,,103.6,3.11,140,160,7
784,784,Kommo-o,0,Dragon,Fighting,Bulletproof,Soundproof,Overcoat,75,110,125,100,105,85,600,0.5,0.5,Hakamo-o,Dragon,,172.4,5.03,210,230,7
785,785,Tapu Koko,0,Electric,Fairy,Electric Surge,Electric Surge,Telepathy,70,115,85,95,75,130,570,NA,NA,,Undiscovered,,45.2,5.11,210,160,7
786,786,Tapu Lele,0,Psychic,Fairy,Psychic Surge,Psychic Surge,Telepathy,70,85,75,130,115,95,570,NA,NA,,Undiscovered,,41,3.11,215,190,7
787,787,Tapu Bulu,0,Grass,Fairy,Grassy Surge,Grassy Surge,Telepathy,70,130,115,85,95,75,570,NA,NA,,Undiscovered,,100.3,6.03,215,210,7
788,788,Tapu Fini,0,Water,Fairy,Misty Surge,Misty Surge,Telepathy,70,75,115,95,130,85,570,NA,NA,,Undiscovered,,46.7,4.03,170,245,7
789,789,Cosmog,0,Psychic,,Unaware,Unaware,Unaware,43,29,31,29,31,37,200,NA,NA,,Undiscovered,,0.2,0.08,58,62,7
790,790,Cosmoem,0,Psychic,,Sturdy,Sturdy,Sturdy,43,29,131,29,131,37,400,NA,NA,Cosmog,Undiscovered,,2204.4,0.04,58,262,7
791,791,Solgaleo,0,Psychic,Steel,Full Metal Body,Full Metal Body,Full Metal Body,137,137,107,113,89,97,680,NA,NA,Cosmoem,Undiscovered,,507.1,11.02,250,196,7
792,792,Lunala,0,Psychic,Ghost,Shadow Shield,Shadow Shield,Shadow Shield,137,113,89,137,107,97,680,NA,NA,Cosmoem,Undiscovered,,264.6,13.01,250,196,7
793,793,Nihilego,0,Rock,Poison,Beast Boost,Beast Boost,Beast Boost,109,53,47,127,131,103,570,NA,NA,,Undiscovered,,122.4,3.11,180,178,7
794,794,Buzzwole,0,Bug,Fighting,Beast Boost,Beast Boost,Beast Boost,107,139,139,53,53,79,570,NA,NA,,Undiscovered,,735.5,7.1,192,192,7
795,795,Pheromosa,0,Bug,Fighting,Beast Boost,Beast Boost,Beast Boost,71,137,37,137,37,151,570,NA,NA,,Undiscovered,,55.1,5.11,274,74,7
796,796,Xurkitree,0,Electric,,Beast Boost,Beast Boost,Beast Boost,83,89,71,173,71,83,570,NA,NA,,Undiscovered,,220.5,12.06,262,142,7
797,797,Celesteela,0,Steel,Flying,Beast Boost,Beast Boost,Beast Boost,97,101,103,107,101,61,570,NA,NA,,Undiscovered,,2204.4,30.02,208,204,7
798,798,Kartana,0,Grass,Steel,Beast Boost,Beast Boost,Beast Boost,59,181,131,59,31,109,570,NA,NA,,Undiscovered,,0.2,1,240,162,7
799,799,Guzzlord,0,Dark,Dragon,Beast Boost,Beast Boost,Beast Boost,223,101,53,97,53,43,570,NA,NA,,Undiscovered,,1957.7,18.01,198,106,7
800,800,Necrozma,0,Psychic,,Prism Armor,Prism Armor,Prism Armor,97,107,101,127,89,79,600,NA,NA,,Undiscovered,,507.1,7.1,234,190,7
801,801,Magearna,0,Steel,Fairy,Soul-Heart,Soul-Heart,Soul-Heart,80,95,115,130,115,65,600,NA,NA,,Undiscovered,,177.5,3.03,225,230,7
802,802,Marshadow,0,Fighting,Ghost,Technician,Technician,Technician,90,125,80,90,90,125,600,NA,NA,,Undiscovered,,48.9,2.04,215,170,7
803,803,Poipole,0,Poison,,Beast Boost,,,67,73,67,73,67,73,420,NA,NA,,Undiscovered,,4,2,146,140,7
804,804,Naganadel,0,Poison,Dragon,Beast Boost,,,73,73,73,127,73,121,540,NA,NA,,Undiscovered,,330.7,11.1,200,194,7
805,805,Stakataka,0,Rock,Steel,Beast Boost,,,61,131,211,53,101,13,570,NA,NA,,Undiscovered,,1807.8,18.01,184,224,7
806,806,Blacephalon,0,Fire,Ghost,Beast Boost,,,53,127,53,151,79,107,570,NA,NA,,Undiscovered,,28.7,5.11,278,160,7
807,807,Zeraora,0,Electric,,Volt Absorb,,,88,112,75,102,80,143,600,NA,NA,,Undiscovered,,98.1,4.11,214,218,7
808,808,Meltan,0,Steel,,Magnet Pull,,,46,65,65,55,35,34,300,NA,NA,,Undiscovered,,17.6,0.08,120,99,7
809,809,Melmetal,0,Steel,,Iron Fist,,,135,143,143,80,65,34,600,NA,NA,,Undiscovered,,1763.7,8.02,223,177,7
